,LOGRECNO,BLOCK,NAME,HU100,INTPTLAT,INTPTLON,H0030001,H0030002,H0030003,H0060001,H0060002,H0060003,H0060004,H0060005,H0060006,H0060007,H0060008
0,94559,1000,Block 1000,78,33.8028705,-84.3387489,78,59,19,59,36,4,1,1,0,17,0
1,94563,1006,Block 1006,20,33.8013004,-84.3397152,20,20,0,20,17,0,0,1,0,0,2
2,94564,1007,Block 1007,20,33.7992594,-84.34228,20,19,1,19,19,0,0,0,0,0,0
3,94565,1008,Block 1008,2,33.7965362,-84.3432178,2,1,1,1,1,0,0,0,0,0,0
4,94566,1009,Block 1009,14,33.7983207,-84.3434816,14,14,0,14,13,0,0,1,0,0,0
5,94567,1010,Block 1010,30,33.7998709,-84.3432667,30,30,0,30,28,1,0,1,0,0,0
6,94568,1011,Block 1011,30,33.8033609,-84.3442794,30,29,1,29,26,1,0,2,0,0,0
7,94569,1012,Block 1012,31,33.8036338,-84.3473839,31,31,0,31,29,1,0,1,0,0,0
8,94570,1013,Block 1013,10,33.8034567,-84.3481053,10,10,0,10,10,0,0,0,0,0,0
9,94571,1015,Block 1015,1,33.805151,-84.3480785,1,0,1,0,0,0,0,0,0,0,0
10,94573,1017,Block 1017,44,33.8006526,-84.3465114,44,43,1,43,42,0,0,0,0,0,1
11,94574,1018,Block 1018,29,33.8019768,-84.3468743,29,28,1,28,26,2,0,0,0,0,0
12,94575,1019,Block 1019,17,33.8007109,-84.3481236,17,16,1,16,16,0,0,0,0,0,0
13,94576,1020,Block 1020,21,33.7976782,-84.3472753,21,21,0,21,20,1,0,0,0,0,0
14,94577,1021,Block 1021,28,33.7985675,-84.3459963,28,28,0,28,27,0,1,0,0,0,0
15,94578,1022,Block 1022,19,33.7999502,-84.3455481,19,19,0,19,19,0,0,0,0,0,0
16,94579,1023,Block 1023,33,33.8016471,-84.3431092,33,33,0,33,32,1,0,0,0,0,0
17,94580,1024,Block 1024,36,33.7962956,-84.3466678,36,33,3,33,31,1,0,0,0,1,0
18,94582,1026,Block 1026,19,33.797469,-84.3452662,19,17,2,17,16,0,0,1,0,0,0
19,94583,1030,Block 1030,13,33.7923002,-84.3469411,13,12,1,12,10,0,0,2,0,0,0
20,94584,1031,Block 1031,20,33.7930251,-84.3468315,20,20,0,20,20,0,0,0,0,0,0
21,94585,1032,Block 1032,23,33.7939544,-84.3467711,23,22,1,22,21,0,0,0,0,0,1
22,94586,1034,Block 1034,27,33.7950962,-84.3469834,27,26,1,26,24,0,0,2,0,0,0
23,94587,1035,Block 1035,4,33.7942374,-84.348051,4,4,0,4,4,0,0,0,0,0,0
24,94588,1036,Block 1036,3,33.797984,-84.3410505,3,3,0,3,3,0,0,0,0,0,0
25,94591,1000,Block 1000,32,33.7767438,-84.3317872,32,31,1,31,30,0,0,0,0,0,1
26,94592,1001,Block 1001,64,33.7757428,-84.3340228,64,62,2,62,54,0,1,4,0,0,3
27,94593,1002,Block 1002,11,33.774883,-84.3347041,11,10,1,10,8,2,0,0,0,0,0
28,94594,1003,Block 1003,15,33.775437,-84.3358796,15,14,1,14,12,0,0,1,0,0,1
29,94595,1004,Block 1004,5,33.7774383,-84.3342964,5,4,1,4,4,0,0,0,0,0,0
30,94596,1005,Block 1005,30,33.7768269,-84.3376126,30,27,3,27,27,0,0,0,0,0,0
31,94597,1006,Block 1006,84,33.7747998,-84.3382709,84,80,4,80,72,4,0,4,0,0,0
32,94598,1007,Block 1007,13,33.7777246,-84.3399152,13,13,0,13,12,1,0,0,0,0,0
33,94599,1008,Block 1008,30,33.7768371,-84.3425995,30,28,2,28,27,1,0,0,0,0,0
34,94600,1009,Block 1009,1,33.7746555,-84.3431592,1,1,0,1,1,0,0,0,0,0,0
35,94602,1011,Block 1011,10,33.7733575,-84.3396885,10,9,1,9,8,1,0,0,0,0,0
36,94603,1012,Block 1012,18,33.773557,-84.3428531,18,15,3,15,14,0,0,1,0,0,0
37,94604,1013,Block 1013,15,33.7722038,-84.3375548,15,14,1,14,14,0,0,0,0,0,0
38,94605,1014,Block 1014,25,33.7726806,-84.3343084,25,20,5,20,20,0,0,0,0,0,0
39,94606,1015,Block 1015,2,33.7727518,-84.332475,2,1,1,1,1,0,0,0,0,0,0
40,94607,1016,Block 1016,1,33.7737993,-84.3334725,1,1,0,1,1,0,0,0,0,0,0
41,94608,1017,Block 1017,12,33.7716073,-84.3405714,12,9,3,9,9,0,0,0,0,0,0
42,94611,2000,Block 2000,78,33.7809562,-84.3472968,78,68,10,68,66,0,0,1,0,0,1
43,94612,2001,Block 2001,21,33.7812056,-84.3482652,21,21,0,21,20,0,0,0,0,0,1
44,94613,2002,Block 2002,1,33.7779567,-84.3482498,1,1,0,1,0,1,0,0,0,0,0
45,94614,2003,Block 2003,224,33.77855,-84.3472876,224,205,19,205,195,4,0,6,0,0,0
46,94615,2004,Block 2004,11,33.7768089,-84.3479677,11,10,1,10,9,0,0,0,0,1,0
47,94616,2005,Block 2005,323,33.7766254,-84.3458212,323,269,54,269,206,44,0,9,0,7,3
48,94617,2006,Block 2006,8,33.7772996,-84.3462336,8,5,3,5,4,1,0,0,0,0,0
49,94618,2007,Block 2007,2,33.7761172,-84.3482669,2,2,0,2,2,0,0,0,0,0,0
50,94620,2009,Block 2009,7,33.7775328,-84.3466527,7,5,2,5,3,0,0,2,0,0,0
51,94622,2011,Block 2011,36,33.7730521,-84.3465216,36,35,1,35,31,1,0,3,0,0,0
52,94623,2012,Block 2012,27,33.7722121,-84.3451675,27,25,2,25,23,1,0,1,0,0,0
53,94624,2013,Block 2013,67,33.7715441,-84.3453198,67,64,3,64,53,3,0,6,0,0,2
54,94625,2014,Block 2014,2,33.7714145,-84.3419227,2,2,0,2,1,0,0,0,0,0,1
55,94628,1000,Block 1000,1,33.7741128,-84.3302853,1,1,0,1,1,0,0,0,0,0,0
56,94630,1002,Block 1002,41,33.7716106,-84.3317549,41,37,4,37,35,1,0,0,0,1,0
57,94631,1003,Block 1003,20,33.7697633,-84.3324395,20,18,2,18,18,0,0,0,0,0,0
58,94632,1004,Block 1004,19,33.7697574,-84.3312551,19,18,1,18,16,1,0,1,0,0,0
59,94633,1005,Block 1005,31,33.7695865,-84.3295768,31,30,1,30,28,1,0,1,0,0,0
60,94634,1006,Block 1006,30,33.7662336,-84.3289981,30,30,0,30,29,0,0,0,0,0,1
61,94635,1007,Block 1007,28,33.7675243,-84.3268053,28,26,2,26,24,0,0,0,0,2,0
62,94636,1008,Block 1008,43,33.7659103,-84.3276595,43,41,2,41,38,3,0,0,0,0,0
63,94637,1009,Block 1009,39,33.76617,-84.3300628,39,36,3,36,35,0,0,1,0,0,0
64,94638,1010,Block 1010,37,33.7661653,-84.3312282,37,35,2,35,32,2,0,0,0,0,1
65,94639,1011,Block 1011,20,33.7682494,-84.3312458,20,20,0,20,17,1,0,1,0,0,1
66,94640,1012,Block 1012,20,33.7682468,-84.3324214,20,20,0,20,19,1,0,0,0,0,0
67,94641,1013,Block 1013,49,33.7661662,-84.3324145,49,45,4,45,44,1,0,0,0,0,0
68,94643,2000,Block 2000,14,33.7710793,-84.3336004,14,14,0,14,13,1,0,0,0,0,0
69,94644,2001,Block 2001,63,33.7695696,-84.3350597,63,61,2,61,57,3,0,0,0,0,1
70,94646,2003,Block 2003,19,33.7659605,-84.336307,19,17,2,17,15,0,0,2,0,0,0
71,94647,2004,Block 2004,18,33.7654738,-84.335727,18,17,1,17,15,1,0,1,0,0,0
72,94648,2005,Block 2005,34,33.7668504,-84.3347853,34,33,1,33,27,0,2,3,0,0,1
73,94649,2006,Block 2006,32,33.7661617,-84.3335744,32,31,1,31,30,0,0,0,0,0,1
74,94650,2007,Block 2007,23,33.7682384,-84.3335785,23,22,1,22,21,0,0,0,0,0,1
75,94651,2008,Block 2008,22,33.7697616,-84.3335961,22,22,0,22,21,0,0,0,0,1,0
76,94652,2009,Block 2009,43,33.7635745,-84.3362499,43,39,4,39,33,2,0,2,0,2,0
77,94653,2010,Block 2010,40,33.7643766,-84.3384248,40,39,1,39,36,1,2,0,0,0,0
78,94654,2011,Block 2011,15,33.7631932,-84.3380753,15,15,0,15,13,0,0,2,0,0,0
79,94656,2013,Block 2013,31,33.7636573,-84.3345311,31,30,1,30,29,1,0,0,0,0,0
80,94657,2014,Block 2014,14,33.7642544,-84.3354194,14,14,0,14,14,0,0,0,0,0,0
81,94658,2015,Block 2015,29,33.7635203,-84.3334767,29,27,2,27,25,2,0,0,0,0,0
82,94661,3000,Block 3000,43,33.767513,-84.3218365,43,40,3,40,39,1,0,0,0,0,0
83,94662,3001,Block 3001,43,33.7666072,-84.3218231,43,41,2,41,35,4,0,1,0,0,1
84,94663,3002,Block 3002,35,33.7665931,-84.3245616,35,34,1,34,30,0,0,4,0,0,0
85,94664,3003,Block 3003,73,33.7635197,-84.3222601,73,69,4,69,57,8,0,2,0,0,2
86,94665,3004,Block 3004,53,33.765372,-84.3221441,53,52,1,52,51,0,0,1,0,0,0
87,94666,3005,Block 3005,9,33.7657694,-84.3179804,9,9,0,9,8,1,0,0,0,0,0
88,94667,3006,Block 3006,21,33.7650017,-84.3178176,21,20,1,20,20,0,0,0,0,0,0
89,94668,3007,Block 3007,37,33.7646908,-84.3201865,37,34,3,34,33,1,0,0,0,0,0
90,94669,3008,Block 3008,25,33.7639432,-84.3191731,25,21,4,21,21,0,0,0,0,0,0
91,94673,3012,Block 3012,18,33.7622829,-84.3224483,18,16,2,16,15,0,0,0,0,1,0
92,94674,3013,Block 3013,29,33.7616353,-84.3236054,29,17,12,17,15,1,0,0,0,0,1
93,94675,3014,Block 3014,163,33.7630214,-84.3261659,163,152,11,152,132,11,0,4,0,0,5
94,94677,3016,Block 3016,51,33.7613516,-84.324962,51,46,5,46,40,4,0,0,0,0,2
95,94678,3017,Block 3017,15,33.7634045,-84.329345,15,15,0,15,14,1,0,0,0,0,0
96,94679,3018,Block 3018,32,33.7643037,-84.3311394,32,26,6,26,24,1,0,0,0,0,1
97,94680,3019,Block 3019,33,33.7634673,-84.3325706,33,30,3,30,28,2,0,0,0,0,0
98,94681,3020,Block 3020,33,33.7627233,-84.3311682,33,31,2,31,28,2,0,1,0,0,0
99,94682,3021,Block 3021,17,33.7624901,-84.3295238,17,15,2,15,15,0,0,0,0,0,0
100,94683,3022,Block 3022,23,33.762205,-84.3280128,23,22,1,22,22,0,0,0,0,0,0
101,94687,3026,Block 3026,23,33.764321,-84.329287,23,22,1,22,20,0,0,2,0,0,0
102,94688,3027,Block 3027,16,33.7611625,-84.3286551,16,16,0,16,14,0,0,0,0,0,2
103,94689,3028,Block 3028,22,33.7615387,-84.3297506,22,22,0,22,20,0,0,0,0,0,2
104,94691,3030,Block 3030,34,33.7609422,-84.3275283,34,30,4,30,25,4,0,1,0,0,0
105,94694,1000,Block 1000,19,33.7698642,-84.3404847,19,19,0,19,16,1,0,2,0,0,0
106,94695,1001,Block 1001,54,33.7699693,-84.3423172,54,43,11,43,36,4,0,2,0,0,1
107,94696,1002,Block 1002,81,33.770061,-84.3458134,81,73,8,73,64,6,0,2,0,1,0
108,94697,1003,Block 1003,169,33.7667499,-84.343176,169,154,15,154,129,16,0,5,0,0,4
109,94698,1004,Block 1004,35,33.7688141,-84.3427087,35,34,1,34,28,2,0,2,0,0,2
110,94699,1005,Block 1005,29,33.7684423,-84.3481215,29,26,3,26,23,2,0,0,0,0,1
111,94700,1006,Block 1006,24,33.7685524,-84.3461445,24,23,1,23,21,1,0,1,0,0,0
112,94701,1007,Block 1007,71,33.7654284,-84.3405778,71,65,6,65,61,0,0,3,0,0,1
113,94702,1008,Block 1008,150,33.7674326,-84.3406516,150,142,8,142,131,9,0,2,0,0,0
114,94703,1009,Block 1009,13,33.7664385,-84.3399239,13,13,0,13,13,0,0,0,0,0,0
115,94704,1010,Block 1010,30,33.7671577,-84.3479304,30,30,0,30,25,2,0,1,0,0,2
116,94705,1011,Block 1011,59,33.7663268,-84.3463144,59,56,3,56,55,0,0,1,0,0,0
117,94706,1012,Block 1012,45,33.7666067,-84.3451714,45,43,2,43,43,0,0,0,0,0,0
118,94707,1013,Block 1013,52,33.7657377,-84.347847,52,48,4,48,43,2,0,1,0,1,1
119,94709,2000,Block 2000,28,33.7642439,-84.3407948,28,25,3,25,20,1,0,2,0,0,2
120,94710,2001,Block 2001,25,33.7641234,-84.3425269,25,22,3,22,22,0,0,0,0,0,0
121,94711,2002,Block 2002,29,33.7640207,-84.3437966,29,29,0,29,26,2,0,1,0,0,0
122,94712,2003,Block 2003,39,33.7639457,-84.3449435,39,37,2,37,35,1,0,0,0,0,1
123,94713,2004,Block 2004,106,33.7629327,-84.3462126,106,101,5,101,86,7,1,5,0,2,0
124,94714,2005,Block 2005,74,33.7628269,-84.3475012,74,72,2,72,64,5,0,3,0,0,0
125,94715,2006,Block 2006,81,33.7628821,-84.3486238,81,77,4,77,63,9,0,1,0,2,2
126,94717,2008,Block 2008,33,33.762502,-84.3425325,33,33,0,33,30,0,0,0,0,0,3
127,94718,2009,Block 2009,11,33.7628208,-84.3403583,11,11,0,11,9,1,0,0,0,1,0
128,94722,2013,Block 2013,52,33.7621714,-84.3443959,52,46,6,46,31,12,0,0,0,1,2
129,94726,1000,Block 1000,22,33.7609089,-84.3427901,22,21,1,21,5,16,0,0,0,0,0
130,94727,1001,Block 1001,10,33.7605806,-84.3465738,10,8,2,8,1,6,0,0,0,0,1
131,94728,1002,Block 1002,16,33.7595447,-84.3466995,16,14,2,14,12,2,0,0,0,0,0
132,94729,1003,Block 1003,121,33.7593995,-84.3444249,121,119,2,119,28,89,0,1,0,0,1
133,94730,1004,Block 1004,42,33.7591208,-84.3428556,42,35,7,35,24,10,0,1,0,0,0
134,94731,1005,Block 1005,209,33.757182,-84.3473965,209,203,6,203,33,158,0,5,0,0,7
135,94732,1006,Block 1006,7,33.7559981,-84.3465023,7,7,0,7,3,3,0,0,0,1,0
136,94733,1007,Block 1007,23,33.7567388,-84.3446463,23,21,2,21,14,6,0,0,0,1,0
137,94734,1008,Block 1008,25,33.7571385,-84.3428977,25,23,2,23,17,6,0,0,0,0,0
138,94735,1009,Block 1009,12,33.755945,-84.3429377,12,11,1,11,7,4,0,0,0,0,0
139,94736,1010,Block 1010,26,33.7544266,-84.3440179,26,20,6,20,8,11,0,0,0,0,1
140,94737,1011,Block 1011,25,33.754448,-84.3452691,25,23,2,23,13,7,0,0,0,0,3
141,94738,1012,Block 1012,26,33.7546139,-84.3469985,26,21,5,21,7,12,0,2,0,0,0
142,94739,1013,Block 1013,30,33.7544115,-84.3486147,30,24,6,24,12,12,0,0,0,0,0
143,94740,1014,Block 1014,26,33.7544355,-84.3427124,26,26,0,26,12,12,0,1,0,0,1
144,94742,1016,Block 1016,65,33.7526709,-84.3459152,65,52,13,52,18,33,0,1,0,0,0
145,94743,1017,Block 1017,15,33.7535559,-84.347042,15,10,5,10,2,8,0,0,0,0,0
146,94744,1018,Block 1018,9,33.7520521,-84.3428188,9,4,5,4,1,3,0,0,0,0,0
147,94746,2000,Block 2000,34,33.7524953,-84.3310704,34,26,8,26,16,9,0,0,0,0,1
148,94747,2001,Block 2001,29,33.7524791,-84.3324481,29,28,1,28,11,16,0,0,0,0,1
149,94748,2002,Block 2002,16,33.7527535,-84.3337833,16,16,0,16,10,6,0,0,0,0,0
150,94749,2003,Block 2003,32,33.7513813,-84.3348202,32,31,1,31,22,8,0,0,0,0,1
151,94752,2006,Block 2006,23,33.7521876,-84.3381654,23,20,3,20,10,10,0,0,0,0,0
152,94753,2007,Block 2007,22,33.7515487,-84.3390971,22,20,2,20,7,13,0,0,0,0,0
153,94754,2008,Block 2008,35,33.7520571,-84.3401625,35,33,2,33,17,16,0,0,0,0,0
154,94755,2009,Block 2009,28,33.7520814,-84.3414269,28,26,2,26,11,15,0,0,0,0,0
155,94756,2010,Block 2010,18,33.7496108,-84.3383922,18,17,1,17,9,8,0,0,0,0,0
156,94757,2011,Block 2011,87,33.748694,-84.3359244,87,70,17,70,18,47,0,2,0,0,3
157,94758,2012,Block 2012,35,33.7503401,-84.3324883,35,31,4,31,13,16,0,2,0,0,0
158,94759,2013,Block 2013,31,33.7503218,-84.331103,31,30,1,30,12,17,0,1,0,0,0
159,94760,2014,Block 2014,19,33.7482563,-84.3311262,19,16,3,16,4,12,0,0,0,0,0
160,94761,2015,Block 2015,17,33.7482683,-84.3325021,17,15,2,15,4,11,0,0,0,0,0
161,94762,2016,Block 2016,47,33.7479741,-84.3342937,47,32,15,32,8,20,1,1,0,0,2
162,94763,2017,Block 2017,7,33.7493691,-84.3406316,7,5,2,5,2,3,0,0,0,0,0
163,94764,2018,Block 2018,29,33.7501608,-84.3410309,29,27,2,27,10,16,0,1,0,0,0
164,94765,2019,Block 2019,14,33.751074,-84.3428538,14,12,2,12,4,7,1,0,0,0,0
165,94766,2020,Block 2020,15,33.7510013,-84.3438318,15,12,3,12,6,6,0,0,0,0,0
166,94767,2021,Block 2021,21,33.7499429,-84.3441305,21,12,9,12,5,6,0,0,0,0,1
167,94768,2022,Block 2022,41,33.7502627,-84.3449621,41,29,12,29,10,18,0,0,0,0,1
168,94769,2023,Block 2023,36,33.7502926,-84.3459274,36,30,6,30,16,13,0,0,0,0,1
169,94770,2024,Block 2024,22,33.7516495,-84.3473289,22,17,5,17,10,7,0,0,0,0,0
170,94771,2025,Block 2025,12,33.7517593,-84.3486692,12,11,1,11,6,5,0,0,0,0,0
171,94772,2026,Block 2026,40,33.750241,-84.3486617,40,33,7,33,18,14,0,0,0,0,1
172,94773,2027,Block 2027,6,33.750693,-84.3477995,6,5,1,5,5,0,0,0,0,0,0
173,94774,2028,Block 2028,19,33.7503541,-84.3469547,19,19,0,19,9,9,0,1,0,0,0
174,94775,2029,Block 2029,4,33.7481684,-84.3459189,4,3,1,3,2,1,0,0,0,0,0
175,94776,2030,Block 2030,3,33.7482308,-84.3449803,3,3,0,3,1,2,0,0,0,0,0
176,94777,2031,Block 2031,42,33.7483445,-84.3433615,42,32,10,32,9,22,0,0,0,0,1
177,94778,2032,Block 2032,9,33.7488719,-84.3405458,9,2,7,2,2,0,0,0,0,0,0
178,94779,2033,Block 2033,132,33.7480824,-84.3398383,132,41,91,41,11,28,0,0,0,0,2
179,94780,2034,Block 2034,5,33.7488711,-84.3486147,5,5,0,5,3,2,0,0,0,0,0
180,94781,2035,Block 2035,7,33.7490245,-84.3477333,7,6,1,6,2,4,0,0,0,0,0
181,94782,2036,Block 2036,8,33.7498295,-84.3477912,8,7,1,7,3,4,0,0,0,0,0
182,94783,2037,Block 2037,13,33.7492189,-84.346984,13,8,5,8,2,5,0,0,0,0,1
183,94786,2040,Block 2040,9,33.7479394,-84.3484821,9,0,9,0,0,0,0,0,0,0,0
184,94787,2041,Block 2041,13,33.7480816,-84.3471345,13,10,3,10,3,6,0,0,0,0,1
185,94788,2042,Block 2042,8,33.750209,-84.3428031,8,8,0,8,4,3,0,0,0,0,1
186,94789,2043,Block 2043,41,33.7500291,-84.3351444,41,35,6,35,14,20,0,0,0,1,0
187,94793,1001,Block 1001,48,33.7588906,-84.3393624,48,32,16,32,14,15,0,0,0,1,2
188,94794,1002,Block 1002,21,33.7592179,-84.3403699,21,21,0,21,7,14,0,0,0,0,0
189,94795,1003,Block 1003,53,33.7579629,-84.34133,53,44,9,44,13,27,2,0,0,1,1
190,94796,1004,Block 1004,22,33.7563999,-84.3396531,22,19,3,19,6,12,0,0,0,0,1
191,94797,1005,Block 1005,9,33.7545105,-84.3389459,9,7,2,7,4,2,0,1,0,0,0
192,94798,1006,Block 1006,17,33.7543702,-84.3394635,17,15,2,15,4,10,0,0,0,0,1
193,94799,1007,Block 1007,12,33.7544287,-84.3402033,12,8,4,8,1,7,0,0,0,0,0
194,94800,1008,Block 1008,23,33.7544189,-84.3413742,23,22,1,22,10,12,0,0,0,0,0
195,94805,2003,Block 2003,3,33.7615371,-84.3360304,3,3,0,3,2,0,0,0,0,0,1
196,94806,2004,Block 2004,397,33.7583923,-84.3332313,397,357,40,357,272,57,1,17,0,5,5
197,94807,2005,Block 2005,13,33.7570242,-84.3370218,13,12,1,12,0,12,0,0,0,0,0
198,94808,2006,Block 2006,208,33.7565277,-84.3350561,208,204,4,204,0,203,0,0,0,1,0
199,94811,2009,Block 2009,20,33.7542295,-84.3297663,20,16,4,16,10,5,0,1,0,0,0
200,94812,2010,Block 2010,20,33.7544104,-84.331031,20,19,1,19,11,6,1,0,0,0,1
201,94813,2011,Block 2011,23,33.7543956,-84.3324297,23,19,4,19,13,5,0,1,0,0,0
202,94814,2012,Block 2012,22,33.7542507,-84.3337137,22,19,3,19,8,11,0,0,0,0,0
203,94815,2013,Block 2013,4,33.7578286,-84.3379928,4,4,0,4,0,4,0,0,0,0,0
204,94816,2014,Block 2014,12,33.758809,-84.3379802,12,12,0,12,4,6,0,1,0,0,1
205,94817,2015,Block 2015,12,33.7544521,-84.3371198,12,8,4,8,5,3,0,0,0,0,0
206,94818,2016,Block 2016,17,33.756508,-84.3379914,17,13,4,13,2,10,1,0,0,0,0
207,94819,2017,Block 2017,13,33.7569986,-84.3360561,13,11,2,11,1,9,0,0,0,0,1
208,94822,1000,Block 1000,41,33.7567313,-84.3274138,41,37,4,37,20,17,0,0,0,0,0
209,94823,1001,Block 1001,48,33.7581172,-84.3253239,48,46,2,46,27,18,0,1,0,0,0
210,94824,1002,Block 1002,22,33.754887,-84.3243947,22,22,0,22,13,8,0,1,0,0,0
211,94825,1003,Block 1003,19,33.7558658,-84.324428,19,17,2,17,8,8,0,1,0,0,0
212,94827,1005,Block 1005,47,33.7582747,-84.3239085,47,46,1,46,28,15,0,2,0,1,0
213,94828,1006,Block 1006,12,33.7537248,-84.3252958,12,10,2,10,6,2,0,0,0,0,2
214,94829,1007,Block 1007,18,33.7533962,-84.3239824,18,17,1,17,9,8,0,0,0,0,0
215,94830,1008,Block 1008,149,33.7510825,-84.3247964,149,110,39,110,19,91,0,0,0,0,0
216,94831,1009,Block 1009,3,33.7529894,-84.326985,3,2,1,2,0,0,0,0,0,1,1
217,94832,1010,Block 1010,117,33.7509646,-84.3285503,117,103,14,103,51,47,0,1,0,0,4
218,94834,1012,Block 1012,146,33.7482597,-84.3285801,146,106,40,106,11,88,0,2,0,0,5
219,94835,1013,Block 1013,21,33.7484364,-84.3267501,21,16,5,16,8,8,0,0,0,0,0
220,94836,1014,Block 1014,28,33.7484153,-84.3257528,28,18,10,18,8,9,0,0,0,0,1
221,94837,1015,Block 1015,20,33.7483968,-84.3247654,20,12,8,12,7,5,0,0,0,0,0
222,94838,1016,Block 1016,19,33.7483795,-84.3237895,19,15,4,15,12,3,0,0,0,0,0
223,94839,1017,Block 1017,24,33.7483504,-84.322551,24,19,5,19,9,10,0,0,0,0,0
224,94840,1018,Block 1018,52,33.750139,-84.3221291,52,40,12,40,23,16,1,0,0,0,0
225,94841,1019,Block 1019,22,33.7483693,-84.321309,22,14,8,14,9,5,0,0,0,0,0
226,94844,2001,Block 2001,14,33.7609554,-84.3211421,14,13,1,13,4,8,0,0,0,0,1
227,94845,2002,Block 2002,84,33.758782,-84.322337,84,72,12,72,37,34,0,0,0,0,1
228,94846,2003,Block 2003,48,33.7599335,-84.3209152,48,43,5,43,12,29,0,0,0,0,2
229,94847,2004,Block 2004,41,33.7582781,-84.3208525,41,31,10,31,22,7,0,1,0,1,0
230,94848,2005,Block 2005,18,33.7567049,-84.3208827,18,18,0,18,14,4,0,0,0,0,0
231,94849,2006,Block 2006,28,33.7560761,-84.3224465,28,26,2,26,23,2,0,1,0,0,0
232,94850,2007,Block 2007,19,33.755765,-84.320928,19,19,0,19,8,8,0,1,0,0,2
233,94852,2009,Block 2009,13,33.7548649,-84.3224384,13,13,0,13,8,4,0,0,0,0,1
234,94853,2010,Block 2010,17,33.7538051,-84.3224438,17,15,2,15,10,5,0,0,0,0,0
235,94854,2011,Block 2011,11,33.7522559,-84.3224637,11,10,1,10,6,4,0,0,0,0,0
236,94855,2012,Block 2012,18,33.7528646,-84.320951,18,15,3,15,7,7,0,1,0,0,0
237,94856,2013,Block 2013,14,33.7517838,-84.320936,14,14,0,14,9,4,0,1,0,0,0
238,94859,1000,Block 1000,21,33.755278,-84.3126598,21,20,1,20,11,9,0,0,0,0,0
239,94860,1001,Block 1001,21,33.7546421,-84.3109533,21,17,4,17,10,6,0,0,0,1,0
240,94861,1002,Block 1002,15,33.7539365,-84.3128596,15,14,1,14,9,5,0,0,0,0,0
241,94862,1003,Block 1003,11,33.7543608,-84.313677,11,10,1,10,3,6,0,0,0,0,1
242,94863,1004,Block 1004,27,33.7543729,-84.3154234,27,26,1,26,14,11,0,0,0,0,1
243,94864,1005,Block 1005,25,33.7541319,-84.3168352,25,17,8,17,11,6,0,0,0,0,0
244,94865,1006,Block 1006,20,33.7542328,-84.3180453,20,19,1,19,15,4,0,0,0,0,0
245,94866,1007,Block 1007,27,33.7542452,-84.3194277,27,25,2,25,14,7,1,2,0,0,1
246,94867,1008,Block 1008,17,33.7527666,-84.3194362,17,17,0,17,8,9,0,0,0,0,0
247,94868,1009,Block 1009,30,33.752188,-84.3180844,30,25,5,25,15,10,0,0,0,0,0
248,94869,1010,Block 1010,27,33.7521772,-84.3168216,27,26,1,26,16,10,0,0,0,0,0
249,94870,1011,Block 1011,19,33.752385,-84.3152981,19,18,1,18,11,7,0,0,0,0,0
250,94871,1012,Block 1012,12,33.7522843,-84.3140858,12,12,0,12,8,4,0,0,0,0,0
251,94872,1013,Block 1013,24,33.7519573,-84.3131351,24,23,1,23,14,9,0,0,0,0,0
252,94873,1014,Block 1014,23,33.7533522,-84.3118863,23,22,1,22,12,9,0,0,0,0,1
253,94876,1017,Block 1017,31,33.7503406,-84.3169694,31,27,4,27,13,14,0,0,0,0,0
254,94877,1018,Block 1018,30,33.7502464,-84.318596,30,29,1,29,17,12,0,0,0,0,0
255,94878,1019,Block 1019,14,33.7517465,-84.3194739,14,11,3,11,4,6,0,0,0,0,1
256,94879,1020,Block 1020,3,33.7505632,-84.3204997,3,2,1,2,0,2,0,0,0,0,0
257,94880,1021,Block 1021,27,33.7484894,-84.3201945,27,24,3,24,15,8,1,0,0,0,0
258,94881,1022,Block 1022,29,33.7484398,-84.3175763,29,24,5,24,14,10,0,0,0,0,0
259,94882,1023,Block 1023,7,33.7505111,-84.3156906,7,4,3,4,2,2,0,0,0,0,0
260,94883,1024,Block 1024,6,33.7504811,-84.3147114,6,6,0,6,1,4,0,0,0,0,1
261,94884,1025,Block 1025,7,33.7507209,-84.3137974,7,6,1,6,3,3,0,0,0,0,0
262,94885,1026,Block 1026,15,33.747999,-84.3155858,15,14,1,14,9,5,0,0,0,0,0
263,94886,1027,Block 1027,20,33.7481866,-84.3147287,20,20,0,20,11,6,0,2,0,1,0
264,94889,2001,Block 2001,19,33.7635179,-84.3160772,19,19,0,19,13,6,0,0,0,0,0
265,94890,2002,Block 2002,33,33.7625143,-84.3177114,33,26,7,26,15,11,0,0,0,0,0
266,94891,2003,Block 2003,39,33.7627971,-84.3153267,39,37,2,37,21,13,0,1,0,0,2
267,94892,2004,Block 2004,44,33.7629478,-84.3141265,44,39,5,39,15,23,0,0,0,1,0
268,94894,2006,Block 2006,36,33.7624764,-84.3129606,36,32,4,32,18,12,0,1,0,0,1
269,94895,2007,Block 2007,26,33.7588924,-84.3125948,26,25,1,25,14,11,0,0,0,0,0
270,94896,2008,Block 2008,38,33.759489,-84.3133016,38,36,2,36,10,25,0,1,0,0,0
271,94897,2009,Block 2009,40,33.759586,-84.3142874,40,39,1,39,18,19,0,0,0,1,1
272,94898,2010,Block 2010,70,33.7588813,-84.3154303,70,64,6,64,42,22,0,0,0,0,0
273,94899,2011,Block 2011,88,33.7597759,-84.3174377,88,83,5,83,56,23,1,2,0,0,1
274,94900,2012,Block 2012,8,33.7582959,-84.3174054,8,8,0,8,7,1,0,0,0,0,0
275,94901,2013,Block 2013,34,33.7608385,-84.319776,34,27,7,27,14,11,1,0,0,0,1
276,94902,2014,Block 2014,6,33.7589995,-84.3195035,6,6,0,6,4,2,0,0,0,0,0
277,94903,2015,Block 2015,19,33.7578836,-84.3193993,19,17,2,17,12,5,0,0,0,0,0
278,94904,2016,Block 2016,47,33.7567498,-84.3168634,47,44,3,44,22,20,0,1,0,0,1
279,94905,2017,Block 2017,33,33.7561582,-84.318669,33,28,5,28,20,7,0,0,0,0,1
280,94906,2018,Block 2018,32,33.756569,-84.3142754,32,31,1,31,17,13,0,0,0,1,0
281,94907,2019,Block 2019,27,33.7565798,-84.3132945,27,26,1,26,15,10,0,0,0,0,1
282,94910,1000,Block 1000,12,33.7511442,-84.2914619,12,11,1,11,4,5,0,1,0,0,1
283,94911,1001,Block 1001,23,33.7501834,-84.2931093,23,23,0,23,11,12,0,0,0,0,0
284,94912,1002,Block 1002,38,33.750207,-84.2950015,38,35,3,35,22,13,0,0,0,0,0
285,94913,1003,Block 1003,26,33.750841,-84.2972684,26,20,6,20,9,10,0,0,0,0,1
286,94914,1004,Block 1004,29,33.7507969,-84.2999209,29,25,4,25,16,6,0,1,0,0,2
287,94915,1005,Block 1005,85,33.7496906,-84.3031601,85,76,9,76,36,38,0,2,0,0,0
288,94916,1006,Block 1006,30,33.7479556,-84.2942118,30,24,6,24,13,11,0,0,0,0,0
289,94917,1007,Block 1007,11,33.748786,-84.291472,11,11,0,11,2,8,0,0,0,0,1
290,94918,1008,Block 1008,25,33.7495853,-84.2999017,25,22,3,22,20,2,0,0,0,0,0
291,94919,1009,Block 1009,26,33.7495931,-84.2973078,26,22,4,22,11,8,1,1,0,0,1
292,94920,1010,Block 1010,22,33.7480387,-84.2973166,22,21,1,21,12,9,0,0,0,0,0
293,94921,1011,Block 1011,67,33.7479872,-84.3001633,67,56,11,56,34,22,0,0,0,0,0
294,94922,1012,Block 1012,18,33.7477849,-84.3038292,18,15,3,15,6,9,0,0,0,0,0
295,94924,2000,Block 2000,16,33.7517172,-84.3059416,16,16,0,16,10,6,0,0,0,0,0
296,94925,2001,Block 2001,15,33.7517356,-84.3074475,15,13,2,13,4,9,0,0,0,0,0
297,94926,2002,Block 2002,14,33.7517407,-84.3089633,14,12,2,12,5,7,0,0,0,0,0
298,94927,2003,Block 2003,13,33.7517393,-84.3104821,13,10,3,10,6,4,0,0,0,0,0
299,94928,2004,Block 2004,9,33.7513671,-84.3118855,9,9,0,9,7,2,0,0,0,0,0
300,94929,2005,Block 2005,23,33.7501842,-84.3122449,23,20,3,20,13,4,0,2,0,0,1
301,94930,2006,Block 2006,22,33.7498162,-84.3104473,22,22,0,22,7,15,0,0,0,0,0
302,94931,2007,Block 2007,8,33.7505619,-84.3089536,8,6,2,6,2,4,0,0,0,0,0
303,94932,2008,Block 2008,12,33.7505472,-84.307468,12,12,0,12,8,3,0,0,0,1,0
304,94933,2009,Block 2009,39,33.7491563,-84.3059368,39,34,5,34,19,15,0,0,0,0,0
305,94935,2011,Block 2011,10,33.7489795,-84.3081018,10,10,0,10,2,7,0,0,0,0,1
306,94936,2012,Block 2012,7,33.7479214,-84.3104969,7,3,4,3,0,3,0,0,0,0,0
307,94937,2013,Block 2013,33,33.7489567,-84.3129558,33,31,2,31,22,7,0,1,0,0,1
308,94938,2014,Block 2014,22,33.7477729,-84.3126361,22,21,1,21,12,9,0,0,0,0,0
309,94940,2016,Block 2016,13,33.7477289,-84.3090858,13,5,8,5,4,1,0,0,0,0,0
310,94942,2018,Block 2018,136,33.7445681,-84.3127498,136,129,7,129,6,118,0,0,0,1,4
311,94943,2019,Block 2019,228,33.7425507,-84.3130663,228,221,7,221,1,217,0,1,0,0,2
312,94944,2020,Block 2020,142,33.741354,-84.3107653,142,141,1,141,0,135,0,0,0,3,3
313,94946,2022,Block 2022,6,33.7396888,-84.3089431,6,5,1,5,1,4,0,0,0,0,0
314,94949,2025,Block 2025,14,33.7397413,-84.3160077,14,10,4,10,1,9,0,0,0,0,0
315,94950,2026,Block 2026,11,33.7398072,-84.319318,11,9,2,9,2,7,0,0,0,0,0
316,94951,2027,Block 2027,6,33.7397455,-84.3073382,6,6,0,6,4,2,0,0,0,0,0
317,94952,2028,Block 2028,7,33.7397242,-84.3058592,7,7,0,7,2,5,0,0,0,0,0
318,94953,2029,Block 2029,2,33.7396181,-84.3043694,2,2,0,2,0,2,0,0,0,0,0
319,94955,3000,Block 3000,16,33.7524009,-84.2914188,16,16,0,16,10,6,0,0,0,0,0
320,94956,3001,Block 3001,24,33.7525406,-84.2928451,24,21,3,21,12,9,0,0,0,0,0
321,94957,3002,Block 3002,38,33.7525151,-84.294806,38,36,2,36,17,19,0,0,0,0,0
322,94958,3003,Block 3003,32,33.7533301,-84.2968295,32,25,7,25,13,11,0,0,0,0,1
323,94959,3004,Block 3004,18,33.7534529,-84.2981075,18,17,1,17,7,10,0,0,0,0,0
324,94960,3005,Block 3005,39,33.7535161,-84.3000368,39,36,3,36,15,20,0,0,0,0,1
325,94961,3006,Block 3006,22,33.7535961,-84.3019465,22,21,1,21,17,4,0,0,0,0,0
326,94962,3007,Block 3007,25,33.7519081,-84.2999854,25,23,2,23,5,16,0,0,0,0,2
327,94963,3008,Block 3008,20,33.7519714,-84.2973022,20,19,1,19,9,9,0,1,0,0,0
328,94964,3009,Block 3009,34,33.7518117,-84.3032822,34,32,2,32,14,18,0,0,0,0,0
329,94965,3010,Block 3010,15,33.7529677,-84.3034488,15,11,4,11,10,1,0,0,0,0,0
330,94966,3011,Block 3011,3,33.752128,-84.3050163,3,3,0,3,1,2,0,0,0,0,0
331,94969,4001,Block 4001,64,33.7458601,-84.2927963,64,55,9,55,11,43,0,0,0,0,1
332,94970,4002,Block 4002,16,33.7460105,-84.2951802,16,14,2,14,8,5,0,0,0,1,0
333,94971,4003,Block 4003,17,33.7460403,-84.296954,17,16,1,16,7,8,0,1,0,0,0
334,94972,4004,Block 4004,17,33.7460661,-84.298447,17,10,7,10,3,7,0,0,0,0,0
335,94974,4006,Block 4006,3,33.7466465,-84.301641,3,3,0,3,2,1,0,0,0,0,0
336,94975,4007,Block 4007,4,33.7461413,-84.30315,4,4,0,4,4,0,0,0,0,0,0
337,94976,4008,Block 4008,17,33.7461547,-84.3043941,17,16,1,16,12,4,0,0,0,0,0
338,94977,4009,Block 4009,20,33.7461851,-84.3067623,20,18,2,18,10,8,0,0,0,0,0
339,94978,4010,Block 4010,15,33.7462446,-84.3090618,15,15,0,15,10,4,0,1,0,0,0
340,94979,4011,Block 4011,2,33.7455938,-84.3016857,2,0,2,0,0,0,0,0,0,0,0
341,94980,4012,Block 4012,6,33.7441776,-84.2913496,6,6,0,6,2,4,0,0,0,0,0
342,94981,4013,Block 4013,19,33.7439315,-84.2926102,19,17,2,17,6,11,0,0,0,0,0
343,94982,4014,Block 4014,25,33.7435372,-84.2942397,25,24,1,24,9,14,0,1,0,0,0
344,94983,4015,Block 4015,11,33.7428187,-84.2906386,11,10,1,10,4,6,0,0,0,0,0
345,94984,4016,Block 4016,19,33.7424546,-84.2917124,19,14,5,14,2,12,0,0,0,0,0
346,94985,4017,Block 4017,25,33.7420121,-84.2927737,25,17,8,17,7,10,0,0,0,0,0
347,94986,4018,Block 4018,11,33.7414896,-84.2943671,11,10,1,10,1,9,0,0,0,0,0
348,94987,4019,Block 4019,6,33.7415147,-84.2903307,6,6,0,6,2,4,0,0,0,0,0
349,94988,4020,Block 4020,18,33.7409442,-84.2910112,18,14,4,14,3,11,0,0,0,0,0
350,94989,4021,Block 4021,20,33.7406079,-84.2924032,20,18,2,18,4,14,0,0,0,0,0
351,94990,4022,Block 4022,15,33.7399691,-84.2943284,15,12,3,12,7,4,0,0,0,0,1
352,94991,4023,Block 4023,5,33.7396288,-84.2907123,5,4,1,4,1,3,0,0,0,0,0
353,94992,4024,Block 4024,21,33.7394825,-84.292257,21,17,4,17,7,10,0,0,0,0,0
354,94993,4025,Block 4025,6,33.7388291,-84.2954649,6,6,0,6,2,3,0,0,0,0,1
355,94994,4026,Block 4026,12,33.7390744,-84.2968222,12,9,3,9,5,4,0,0,0,0,0
356,94995,4027,Block 4027,13,33.7391146,-84.2985819,13,8,5,8,3,4,0,1,0,0,0
357,94996,4028,Block 4028,13,33.7391198,-84.2999121,13,12,1,12,6,6,0,0,0,0,0
358,95005,1003,Block 1003,24,33.7468815,-84.3347022,24,15,9,15,6,7,0,0,0,1,1
359,95006,1004,Block 1004,26,33.746423,-84.338263,26,18,8,18,4,14,0,0,0,0,0
360,95007,1005,Block 1005,68,33.7464562,-84.3439869,68,56,12,56,24,30,0,2,0,0,0
361,95008,1006,Block 1006,80,33.7468456,-84.3475308,80,52,28,52,8,41,1,0,0,2,0
362,95016,1014,Block 1014,30,33.7445842,-84.3461905,30,25,5,25,9,16,0,0,0,0,0
363,95017,1015,Block 1015,74,33.7446707,-84.3391813,74,66,8,66,38,27,0,1,0,0,0
364,95019,1017,Block 1017,75,33.7419878,-84.3335436,75,68,7,68,28,39,0,1,0,0,0
365,95020,1018,Block 1018,59,33.7424335,-84.3359234,59,54,5,54,32,20,0,0,0,0,2
366,95021,1019,Block 1019,16,33.7436793,-84.3390642,16,14,2,14,8,4,0,0,0,0,2
367,95022,1020,Block 1020,24,33.7432639,-84.3405832,24,19,5,19,13,5,0,0,0,0,1
368,95023,1021,Block 1021,28,33.7434392,-84.342094,28,24,4,24,12,10,0,0,0,0,2
369,95024,1022,Block 1022,32,33.7435486,-84.3436199,32,28,4,28,20,8,0,0,0,0,0
370,95025,1023,Block 1023,38,33.7435023,-84.346276,38,36,2,36,28,7,0,0,0,0,1
371,95026,1024,Block 1024,46,33.741677,-84.3391111,46,41,5,41,23,17,0,1,0,0,0
372,95027,1025,Block 1025,59,33.7416641,-84.3372005,59,45,14,45,26,19,0,0,0,0,0
373,95028,1026,Block 1026,28,33.7412311,-84.3406278,28,28,0,28,20,6,0,1,0,1,0
374,95029,1027,Block 1027,31,33.7413152,-84.3421169,31,27,4,27,18,6,0,1,0,0,2
375,95030,1028,Block 1028,27,33.7414102,-84.3436314,27,23,4,23,16,6,0,0,0,0,1
376,95031,1029,Block 1029,15,33.741991,-84.3448522,15,13,2,13,11,2,0,0,0,0,0
377,95032,1030,Block 1030,24,33.7427192,-84.3459252,24,24,0,24,13,9,0,1,0,0,1
378,95040,1038,Block 1038,4,33.7412047,-84.3455821,4,4,0,4,3,0,0,0,0,0,1
379,95041,1039,Block 1039,174,33.7408516,-84.3476393,174,169,5,169,19,147,0,1,0,0,2
380,95044,2000,Block 2000,44,33.7395676,-84.3411418,44,38,6,38,24,13,0,0,0,1,0
381,95045,2001,Block 2001,1,33.7396801,-84.34385,1,1,0,1,0,0,0,0,0,0,1
382,95047,2003,Block 2003,5,33.739616,-84.3463261,5,5,0,5,3,1,0,0,0,0,1
383,95048,2004,Block 2004,5,33.739614,-84.3474389,5,4,1,4,3,0,0,1,0,0,0
384,95050,2006,Block 2006,14,33.7385475,-84.348646,14,9,5,9,6,3,0,0,0,0,0
385,95051,2007,Block 2007,28,33.7379852,-84.3469448,28,25,3,25,15,9,0,0,0,0,1
386,95052,2008,Block 2008,12,33.7384941,-84.3452666,12,11,1,11,5,4,0,1,0,0,1
387,95053,2009,Block 2009,31,33.7382769,-84.3440154,31,30,1,30,20,9,0,0,0,1,0
388,95054,2010,Block 2010,20,33.7386298,-84.3424128,20,19,1,19,11,6,0,1,0,0,1
389,95055,2011,Block 2011,19,33.7385469,-84.3403745,19,18,1,18,11,7,0,0,0,0,0
390,95056,2012,Block 2012,27,33.7376504,-84.3410795,27,26,1,26,15,11,0,0,0,0,0
391,95057,2013,Block 2013,46,33.7365325,-84.3434462,46,42,4,42,29,12,0,0,0,1,0
392,95058,2014,Block 2014,10,33.737435,-84.3452892,10,10,0,10,7,3,0,0,0,0,0
393,95059,2015,Block 2015,32,33.7354763,-84.3452823,32,31,1,31,24,7,0,0,0,0,0
394,95060,2016,Block 2016,36,33.7354805,-84.346946,36,31,5,31,24,5,0,0,0,0,2
395,95061,2017,Block 2017,17,33.7363535,-84.3486571,17,16,1,16,14,2,0,0,0,0,0
396,95062,2018,Block 2018,18,33.7374465,-84.348651,18,18,0,18,15,1,0,0,0,0,2
397,95063,2019,Block 2019,18,33.7349411,-84.348669,18,15,3,15,14,1,0,0,0,0,0
398,95064,2020,Block 2020,19,33.7335283,-84.3486687,19,13,6,13,9,4,0,0,0,0,0
399,95065,2021,Block 2021,24,33.7335064,-84.3469329,24,21,3,21,19,0,0,1,0,0,1
400,95066,2022,Block 2022,21,33.733046,-84.3452955,21,20,1,20,18,2,0,0,0,0,0
401,95067,2023,Block 2023,15,33.7330482,-84.3441623,15,14,1,14,7,6,0,0,0,0,1
402,95068,2024,Block 2024,28,33.7348119,-84.3427124,28,27,1,27,19,8,0,0,0,0,0
403,95069,2025,Block 2025,13,33.7353445,-84.340626,13,13,0,13,4,9,0,0,0,0,0
404,95070,2026,Block 2026,26,33.7367577,-84.3404122,26,20,6,20,7,13,0,0,0,0,0
405,95071,2027,Block 2027,12,33.7357559,-84.3393374,12,12,0,12,5,7,0,0,0,0,0
406,95072,2028,Block 2028,20,33.7343243,-84.3393429,20,19,1,19,13,6,0,0,0,0,0
407,95073,2029,Block 2029,27,33.7329678,-84.3413499,27,23,4,23,11,11,0,0,1,0,0
408,95074,2030,Block 2030,12,33.7324934,-84.3469776,12,12,0,12,8,3,0,1,0,0,0
409,95075,2031,Block 2031,48,33.7310949,-84.3487926,48,39,9,39,19,17,0,0,0,1,2
410,95076,2032,Block 2032,11,33.7283252,-84.3488101,11,11,0,11,5,5,0,0,0,1,0
411,95077,2033,Block 2033,15,33.7269585,-84.3487963,15,10,5,10,8,1,0,0,0,1,0
412,95078,2034,Block 2034,4,33.7251282,-84.3488822,4,3,1,3,2,1,0,0,0,0,0
413,95079,2035,Block 2035,1,33.722869,-84.3489743,1,1,0,1,0,1,0,0,0,0,0
414,95081,3000,Block 3000,30,33.7381742,-84.3304601,30,26,4,26,8,17,0,0,0,1,0
415,95082,3001,Block 3001,21,33.7362311,-84.330596,21,20,1,20,7,12,0,1,0,0,0
416,95083,3002,Block 3002,26,33.7394477,-84.3335864,26,23,3,23,7,16,0,0,0,0,0
417,95084,3003,Block 3003,22,33.7395018,-84.3362824,22,19,3,19,9,10,0,0,0,0,0
418,95085,3004,Block 3004,17,33.7395308,-84.3384399,17,16,1,16,5,11,0,0,0,0,0
419,95086,3005,Block 3005,15,33.7385173,-84.3384582,15,13,2,13,6,7,0,0,0,0,0
420,95087,3006,Block 3006,21,33.7384802,-84.3362855,21,20,1,20,6,14,0,0,0,0,0
421,95088,3007,Block 3007,29,33.7384255,-84.3336058,29,27,2,27,17,10,0,0,0,0,0
422,95089,3008,Block 3008,26,33.7374901,-84.3336359,26,26,0,26,11,15,0,0,0,0,0
423,95090,3009,Block 3009,36,33.7375753,-84.3372126,36,33,3,33,7,25,1,0,0,0,0
424,95091,3010,Block 3010,63,33.736664,-84.3348382,63,59,4,59,22,37,0,0,0,0,0
425,95092,3011,Block 3011,59,33.7356379,-84.3344502,59,55,4,55,24,30,0,1,0,0,0
426,95093,3012,Block 3012,10,33.7357731,-84.3381567,10,10,0,10,4,6,0,0,0,0,0
427,95094,3013,Block 3013,27,33.7340055,-84.3382602,27,27,0,27,8,18,0,1,0,0,0
428,95095,3014,Block 3014,39,33.7329901,-84.3367374,39,32,7,32,15,17,0,0,0,0,0
429,95096,3015,Block 3015,101,33.7318035,-84.3342395,101,90,11,90,48,41,0,1,0,0,0
430,95097,3016,Block 3016,36,33.7333623,-84.3322,36,33,3,33,17,16,0,0,0,0,0
431,95098,3017,Block 3017,7,33.7335575,-84.329563,7,6,1,6,2,4,0,0,0,0,0
432,95099,3018,Block 3018,26,33.7319365,-84.33085,26,22,4,22,7,14,0,1,0,0,0
433,95100,3019,Block 3019,9,33.7314853,-84.3294241,9,7,2,7,2,3,0,0,0,0,2
434,95102,4000,Block 4000,24,33.7298119,-84.328344,24,20,4,20,6,12,0,2,0,0,0
435,95103,4001,Block 4001,160,33.7263465,-84.3295952,160,152,8,152,73,77,0,1,0,0,1
436,95104,4002,Block 4002,4,33.7233203,-84.3325808,4,4,0,4,2,2,0,0,0,0,0
437,95105,4003,Block 4003,7,33.7245254,-84.3328195,7,6,1,6,3,3,0,0,0,0,0
438,95106,4004,Block 4004,13,33.7264558,-84.3319677,13,13,0,13,5,7,0,0,0,0,1
439,95107,4005,Block 4005,29,33.7298819,-84.331842,29,26,3,26,12,13,1,0,0,0,0
440,95108,4006,Block 4006,29,33.7297455,-84.3332089,29,24,5,24,12,11,0,0,0,0,1
441,95109,4007,Block 4007,17,33.73015,-84.3347468,17,14,3,14,9,5,0,0,0,0,0
442,95110,4008,Block 4008,9,33.729743,-84.3358625,9,9,0,9,5,4,0,0,0,0,0
443,95111,4009,Block 4009,5,33.7312374,-84.3377639,5,4,1,4,1,3,0,0,0,0,0
444,95112,4010,Block 4010,5,33.7261106,-84.3332928,5,5,0,5,3,2,0,0,0,0,0
445,95113,4011,Block 4011,7,33.727926,-84.3342008,7,6,1,6,3,3,0,0,0,0,0
446,95114,4012,Block 4012,20,33.7286393,-84.3259471,20,19,1,19,7,10,0,2,0,0,0
447,95116,4014,Block 4014,22,33.7217876,-84.3301708,22,21,1,21,4,15,0,2,0,0,0
448,95117,4015,Block 4015,6,33.7223172,-84.3322482,6,5,1,5,4,1,0,0,0,0,0
449,95118,4016,Block 4016,5,33.7211386,-84.3316541,5,4,1,4,2,2,0,0,0,0,0
450,95119,4017,Block 4017,3,33.7197976,-84.3306327,3,3,0,3,1,2,0,0,0,0,0
451,95120,4018,Block 4018,1,33.719011,-84.329723,1,0,1,0,0,0,0,0,0,0,0
452,95121,4019,Block 4019,30,33.7223696,-84.3274463,30,24,6,24,6,17,1,0,0,0,0
453,95122,4020,Block 4020,28,33.7265282,-84.3256392,28,26,2,26,11,15,0,0,0,0,0
454,95124,4022,Block 4022,112,33.727665,-84.3244589,112,92,20,92,1,87,0,0,0,2,2
455,95127,4025,Block 4025,30,33.7267728,-84.3225417,30,2,28,2,1,1,0,0,0,0,0
456,95131,4029,Block 4029,1,33.7253014,-84.3232666,1,1,0,1,1,0,0,0,0,0,0
457,95143,4000,Block 4000,29,33.7454731,-84.3148624,29,28,1,28,0,27,0,1,0,0,0
458,95145,4002,Block 4002,31,33.7468616,-84.3166438,31,28,3,28,0,27,0,0,0,0,1
459,95146,4003,Block 4003,1,33.747175,-84.3177053,1,1,0,1,0,1,0,0,0,0,0
460,95147,4005,Block 4005,13,33.7466508,-84.3176815,13,13,0,13,1,11,0,0,0,0,1
461,95148,4016,Block 4016,19,33.7415272,-84.315308,19,19,0,19,0,19,0,0,0,0,0
462,95149,4017,Block 4017,2,33.7433635,-84.3161285,2,2,0,2,0,1,0,1,0,0,0
463,131355,1000,Block 1000,32,33.7915696,-84.3525692,32,29,3,29,28,0,0,1,0,0,0
464,131356,1001,Block 1001,60,33.7907205,-84.3498644,60,55,5,55,49,4,0,2,0,0,0
465,131358,1003,Block 1003,28,33.7896359,-84.3530745,28,24,4,24,23,1,0,0,0,0,0
466,131359,1004,Block 1004,28,33.7902813,-84.35471,28,25,3,25,25,0,0,0,0,0,0
467,131360,1005,Block 1005,23,33.791238,-84.3544107,23,20,3,20,20,0,0,0,0,0,0
468,131361,1006,Block 1006,31,33.7901959,-84.3508405,31,28,3,28,27,0,0,1,0,0,0
469,131362,1007,Block 1007,22,33.7892526,-84.3546662,22,21,1,21,20,0,0,1,0,0,0
470,131363,1008,Block 1008,70,33.7881396,-84.3526249,70,64,6,64,59,2,0,0,0,0,3
471,131364,1009,Block 1009,28,33.7893228,-84.3514983,28,25,3,25,23,0,0,2,0,0,0
472,131365,1010,Block 1010,11,33.7881662,-84.3491146,11,9,2,9,9,0,0,0,0,0,0
473,131366,1011,Block 1011,19,33.7870389,-84.3519244,19,18,1,18,18,0,0,0,0,0,0
474,131367,1012,Block 1012,34,33.787054,-84.3540494,34,30,4,30,28,0,0,0,0,1,1
475,131369,2000,Block 2000,27,33.7858095,-84.3491524,27,27,0,27,27,0,0,0,0,0,0
476,131370,2001,Block 2001,65,33.7855197,-84.3519148,65,63,2,63,60,1,0,0,0,0,2
477,131371,2002,Block 2002,36,33.7840683,-84.3509782,36,36,0,36,35,0,0,0,0,0,1
478,131372,2003,Block 2003,42,33.7839548,-84.3535295,42,38,4,38,35,0,0,1,0,0,2
479,131373,2004,Block 2004,20,33.7829268,-84.3536921,20,17,3,17,15,0,0,0,0,0,2
480,131374,2005,Block 2005,67,33.7824752,-84.3512734,67,63,4,63,56,5,0,1,0,0,1
481,131375,2006,Block 2006,20,33.7833349,-84.3503932,20,20,0,20,19,0,0,1,0,0,0
482,131376,2007,Block 2007,15,33.7828317,-84.3489186,15,14,1,14,12,2,0,0,0,0,0
483,131377,2008,Block 2008,18,33.7809886,-84.3488535,18,18,0,18,16,0,0,2,0,0,0
484,131379,2010,Block 2010,45,33.7859987,-84.3532233,45,44,1,44,44,0,0,0,0,0,0
485,131381,3000,Block 3000,16,33.8092819,-84.3501286,16,16,0,16,13,3,0,0,0,0,0
486,131382,3001,Block 3001,48,33.8078993,-84.3534165,48,46,2,46,41,4,0,1,0,0,0
487,131383,3002,Block 3002,5,33.8071519,-84.3537379,5,5,0,5,4,1,0,0,0,0,0
488,131384,3003,Block 3003,10,33.8077491,-84.3530575,10,9,1,9,9,0,0,0,0,0,0
489,131385,3004,Block 3004,16,33.8075566,-84.3526822,16,16,0,16,14,0,0,1,0,1,0
490,131386,3005,Block 3005,10,33.806822,-84.3536341,10,10,0,10,9,0,0,1,0,0,0
491,131388,3007,Block 3007,27,33.8072692,-84.35785,27,24,3,24,24,0,0,0,0,0,0
492,131389,3008,Block 3008,7,33.8092752,-84.3595696,7,7,0,7,6,0,0,0,0,1,0
493,131390,3009,Block 3009,149,33.8063865,-84.3621512,149,140,9,140,126,7,0,6,0,1,0
494,131391,3010,Block 3010,43,33.8055906,-84.3652943,43,36,7,36,31,3,0,2,0,0,0
495,131393,3012,Block 3012,49,33.8020786,-84.361612,49,49,0,49,47,1,0,1,0,0,0
496,131394,3013,Block 3013,47,33.8018649,-84.3580584,47,44,3,44,44,0,0,0,0,0,0
497,131395,3014,Block 3014,13,33.8032066,-84.3541098,13,13,0,13,13,0,0,0,0,0,0
498,131396,3015,Block 3015,36,33.804582,-84.3535832,36,35,1,35,33,0,0,1,0,1,0
499,131397,3016,Block 3016,30,33.802728,-84.3491926,30,30,0,30,26,1,0,3,0,0,0
500,131400,3019,Block 3019,9,33.8066363,-84.3497731,9,9,0,9,9,0,0,0,0,0,0
501,131401,3020,Block 3020,11,33.8078936,-84.349382,11,11,0,11,10,1,0,0,0,0,0
502,131402,3021,Block 3021,20,33.8004634,-84.3516736,20,20,0,20,19,1,0,0,0,0,0
503,131404,3023,Block 3023,18,33.8020633,-84.3533506,18,18,0,18,16,1,0,1,0,0,0
504,131405,3024,Block 3024,15,33.7997992,-84.3549254,15,13,2,13,13,0,0,0,0,0,0
505,131406,3025,Block 3025,21,33.8002132,-84.3563225,21,21,0,21,21,0,0,0,0,0,0
506,131407,3026,Block 3026,14,33.7994878,-84.3582844,14,14,0,14,14,0,0,0,0,0,0
507,131408,3027,Block 3027,66,33.8001033,-84.361639,66,61,5,61,58,1,1,1,0,0,0
508,131410,3029,Block 3029,26,33.798087,-84.3512125,26,25,1,25,25,0,0,0,0,0,0
509,131412,3031,Block 3031,14,33.7983354,-84.3533748,14,14,0,14,13,1,0,0,0,0,0
510,131414,3033,Block 3033,24,33.8012728,-84.3504911,24,23,1,23,20,1,0,2,0,0,0
511,131416,4000,Block 4000,4,33.7981297,-84.3484356,4,4,0,4,4,0,0,0,0,0,0
512,131417,4001,Block 4001,19,33.7971194,-84.3489523,19,17,2,17,14,1,0,1,0,1,0
513,131418,4002,Block 4002,30,33.7957577,-84.3493035,30,28,2,28,27,0,1,0,0,0,0
514,131419,4003,Block 4003,21,33.7964703,-84.3511793,21,21,0,21,19,0,0,1,0,0,1
515,131420,4004,Block 4004,14,33.7965705,-84.3531152,14,13,1,13,13,0,0,0,0,0,0
516,131421,4005,Block 4005,58,33.7966209,-84.3566117,58,56,2,56,51,2,0,1,0,0,2
517,131422,4006,Block 4006,39,33.798154,-84.357,39,38,1,38,36,0,0,2,0,0,0
518,131424,4008,Block 4008,64,33.7939735,-84.3569304,64,58,6,58,55,1,0,0,0,2,0
519,131425,4009,Block 4009,80,33.7938398,-84.3550984,80,75,5,75,71,4,0,0,0,0,0
520,131426,4010,Block 4010,58,33.7938716,-84.353277,58,54,4,54,51,2,0,0,0,0,1
521,131427,4011,Block 4011,26,33.7952397,-84.3519521,26,21,5,21,21,0,0,0,0,0,0
522,131428,4012,Block 4012,29,33.7946225,-84.3495469,29,29,0,29,28,1,0,0,0,0,0
523,131429,4013,Block 4013,28,33.7936322,-84.3497104,28,26,2,26,26,0,0,0,0,0,0
524,131430,4014,Block 4014,22,33.7943522,-84.3521819,22,22,0,22,20,1,0,0,0,0,1
525,131431,4015,Block 4015,35,33.7926136,-84.349812,35,34,1,34,33,0,0,1,0,0,0
526,131434,1000,Block 1000,104,33.8031313,-84.3663521,104,85,19,85,65,15,1,2,0,0,2
527,131435,1001,Block 1001,10,33.8021384,-84.3684687,10,10,0,10,8,1,0,1,0,0,0
528,131436,1002,Block 1002,75,33.8004792,-84.3652778,75,70,5,70,61,6,0,3,0,0,0
529,131438,1004,Block 1004,42,33.7978784,-84.360921,42,41,1,41,39,2,0,0,0,0,0
530,131439,1005,Block 1005,2,33.7978511,-84.3595118,2,2,0,2,2,0,0,0,0,0,0
531,131440,1006,Block 1006,26,33.798945,-84.3643594,26,24,2,24,21,3,0,0,0,0,0
532,131441,1007,Block 1007,36,33.7983921,-84.3671225,36,33,3,33,31,1,0,1,0,0,0
533,131442,1008,Block 1008,346,33.7999468,-84.3697453,346,317,29,317,259,38,0,7,0,4,9
534,131443,1009,Block 1009,21,33.7991236,-84.3716604,21,13,8,13,12,1,0,0,0,0,0
535,131447,2000,Block 2000,23,33.7969565,-84.3614819,23,21,2,21,20,0,0,0,0,0,1
536,131448,2001,Block 2001,11,33.7980406,-84.3643,11,11,0,11,11,0,0,0,0,0,0
537,131449,2002,Block 2002,20,33.7973022,-84.3667839,20,19,1,19,19,0,0,0,0,0,0
538,131450,2003,Block 2003,44,33.7957092,-84.3611799,44,44,0,44,43,0,0,0,0,1,0
539,131451,2004,Block 2004,29,33.7966356,-84.3641781,29,28,1,28,28,0,0,0,0,0,0
540,131452,2005,Block 2005,15,33.7966987,-84.3666109,15,14,1,14,14,0,0,0,0,0,0
541,131453,2006,Block 2006,9,33.7974327,-84.3641784,9,8,1,8,7,0,0,1,0,0,0
542,131454,2007,Block 2007,15,33.7952325,-84.3684065,15,11,4,11,10,0,0,1,0,0,0
543,131455,2008,Block 2008,41,33.7957415,-84.3656763,41,40,1,40,40,0,0,0,0,0,0
544,131456,2009,Block 2009,193,33.7932619,-84.3627453,193,179,14,179,168,8,0,1,0,0,2
545,131457,2010,Block 2010,35,33.7936112,-84.3607772,35,31,4,31,29,0,0,2,0,0,0
546,131458,2011,Block 2011,2,33.7945054,-84.3620403,2,2,0,2,2,0,0,0,0,0,0
547,131459,2012,Block 2012,224,33.794202,-84.3650324,224,207,17,207,180,8,0,11,0,5,3
548,131460,2013,Block 2013,16,33.7928075,-84.3675664,16,13,3,13,13,0,0,0,0,0,0
549,131461,2014,Block 2014,106,33.7925695,-84.3687929,106,97,9,97,85,4,0,6,0,0,2
550,131464,3000,Block 3000,32,33.7916648,-84.3602509,32,32,0,32,30,1,0,1,0,0,0
551,131465,3001,Block 3001,44,33.7912026,-84.3579947,44,38,6,38,35,0,0,2,0,0,1
552,131466,3002,Block 3002,40,33.791161,-84.3623924,40,40,0,40,40,0,0,0,0,0,0
553,131467,3003,Block 3003,108,33.7906889,-84.365451,108,99,9,99,90,6,1,1,0,1,0
554,131468,3004,Block 3004,61,33.7884472,-84.3629824,61,60,1,60,57,0,0,1,0,1,1
555,131469,3005,Block 3005,108,33.7891986,-84.3587437,108,101,7,101,93,2,0,2,0,0,4
556,131470,3006,Block 3006,48,33.7881106,-84.3586872,48,45,3,45,45,0,0,0,0,0,0
557,131471,3007,Block 3007,15,33.7905749,-84.3588624,15,15,0,15,15,0,0,0,0,0,0
558,131473,4000,Block 4000,72,33.7867628,-84.356955,72,66,6,66,64,1,0,1,0,0,0
559,131474,4001,Block 4001,36,33.7870453,-84.3600652,36,36,0,36,36,0,0,0,0,0,0
560,131475,4002,Block 4002,62,33.7863036,-84.3611306,62,60,2,60,60,0,0,0,0,0,0
561,131476,4003,Block 4003,17,33.7872807,-84.3641643,17,16,1,16,15,1,0,0,0,0,0
562,131477,4004,Block 4004,31,33.7873069,-84.365651,31,30,1,30,28,1,0,0,0,0,1
563,131478,4005,Block 4005,59,33.7874311,-84.3692056,59,49,10,49,46,3,0,0,0,0,0
564,131479,4006,Block 4006,41,33.7899079,-84.3688313,41,40,1,40,36,3,0,1,0,0,0
565,131481,4008,Block 4008,2,33.7844582,-84.3589026,2,2,0,2,2,0,0,0,0,0,0
566,131483,4010,Block 4010,49,33.7855131,-84.3644119,49,47,2,47,44,0,0,1,0,0,2
567,131484,4011,Block 4011,27,33.7863177,-84.3666195,27,25,2,25,22,0,0,0,0,0,3
568,131485,4012,Block 4012,40,33.7864649,-84.3683845,40,36,4,36,32,0,1,3,0,0,0
569,131486,4013,Block 4013,55,33.7854301,-84.3568282,55,47,8,47,44,0,0,2,0,0,1
570,131487,4014,Block 4014,50,33.7844,-84.3567204,50,50,0,50,49,1,0,0,0,0,0
571,131489,5000,Block 5000,18,33.7830699,-84.3551347,18,16,2,16,13,2,0,1,0,0,0
572,131490,5001,Block 5001,23,33.7830637,-84.356338,23,21,2,21,21,0,0,0,0,0,0
573,131491,5002,Block 5002,36,33.7830163,-84.3577995,36,29,7,29,28,1,0,0,0,0,0
574,131492,5003,Block 5003,77,33.7834803,-84.3611778,77,68,9,68,59,3,0,3,0,2,1
575,131493,5004,Block 5004,51,33.784737,-84.3656885,51,49,2,49,47,0,0,1,0,0,1
576,131494,5005,Block 5005,30,33.7854216,-84.3685674,30,27,3,27,25,0,0,0,0,0,2
577,131495,5006,Block 5006,60,33.7843341,-84.3692434,60,58,2,58,53,4,0,0,0,0,1
578,131496,5007,Block 5007,36,33.7840674,-84.3665934,36,33,3,33,31,1,0,1,0,0,0
579,131497,5008,Block 5008,52,33.783108,-84.3660387,52,49,3,49,44,1,0,2,1,1,0
580,131499,5010,Block 5010,12,33.7824664,-84.360656,12,12,0,12,10,1,0,0,0,0,1
581,131500,5011,Block 5011,43,33.7821046,-84.3659781,43,41,2,41,40,0,0,1,0,0,0
582,131502,5013,Block 5013,32,33.7846245,-84.3615215,32,29,3,29,26,1,0,2,0,0,0
583,131505,1000,Block 1000,51,33.7919029,-84.3806799,51,46,5,46,45,0,0,0,0,1,0
584,131506,1001,Block 1001,31,33.7925964,-84.382524,31,30,1,30,30,0,0,0,0,0,0
585,131507,1002,Block 1002,67,33.7921191,-84.3847125,67,52,15,52,48,4,0,0,0,0,0
586,131508,1003,Block 1003,97,33.7943149,-84.3860026,97,86,11,86,77,6,0,1,0,0,2
587,131513,1008,Block 1008,41,33.7899949,-84.3836907,41,29,12,29,29,0,0,0,0,0,0
588,131520,1015,Block 1015,2,33.7874989,-84.3849095,2,1,1,1,1,0,0,0,0,0,0
589,131523,1018,Block 1018,14,33.789494,-84.3817394,14,14,0,14,13,1,0,0,0,0,0
590,131529,2004,Block 2004,109,33.79076,-84.3757506,109,92,17,92,70,18,1,1,0,2,0
591,131530,2005,Block 2005,35,33.7905647,-84.3776013,35,31,4,31,31,0,0,0,0,0,0
592,131531,2006,Block 2006,4,33.7851847,-84.3779184,4,0,4,0,0,0,0,0,0,0,0
593,131539,2014,Block 2014,55,33.7891495,-84.3798958,55,51,4,51,47,2,1,0,0,0,1
594,131540,2015,Block 2015,74,33.7890736,-84.3775787,74,68,6,68,64,3,0,1,0,0,0
595,131541,2016,Block 2016,595,33.7875669,-84.3807473,595,498,97,498,411,52,0,21,0,1,13
596,131547,1002,Block 1002,352,33.7984169,-84.3933552,352,336,16,336,184,98,2,28,0,8,16
597,131555,1010,Block 1010,156,33.7972344,-84.3915887,156,148,8,148,91,35,0,7,0,9,6
598,131572,1027,Block 1027,31,33.7925604,-84.3884571,31,30,1,30,18,6,0,1,0,2,3
599,131573,1028,Block 1028,23,33.7940213,-84.3884632,23,20,3,20,15,4,0,0,0,0,1
600,131575,1030,Block 1030,4,33.7944121,-84.3963219,4,4,0,4,2,0,0,1,0,0,1
601,131577,1032,Block 1032,85,33.7922908,-84.3980857,85,72,13,72,18,43,1,3,1,2,4
602,131578,1033,Block 1033,36,33.7926331,-84.3943262,36,2,34,2,2,0,0,0,0,0,0
603,131580,1035,Block 1035,77,33.7937523,-84.3963254,77,28,49,28,18,7,0,2,0,0,1
604,131589,1044,Block 1044,21,33.789341,-84.3938812,21,18,3,18,13,3,0,2,0,0,0
605,131590,1045,Block 1045,1,33.7900273,-84.3941671,1,1,0,1,0,0,0,0,0,0,1
606,131591,1046,Block 1046,27,33.7905969,-84.3941812,27,25,2,25,15,4,0,6,0,0,0
607,131601,1056,Block 1056,42,33.7921019,-84.3969241,42,10,32,10,7,1,0,2,0,0,0
608,131606,1061,Block 1061,58,33.7915375,-84.3969401,58,51,7,51,16,35,0,0,0,0,0
609,131607,1062,Block 1062,378,33.7912096,-84.3968674,378,297,81,297,102,124,0,58,0,1,12
610,131608,1063,Block 1063,407,33.7906041,-84.3969652,407,7,400,7,3,3,0,1,0,0,0
611,131609,1064,Block 1064,21,33.7900424,-84.3960221,21,21,0,21,11,9,0,1,0,0,0
612,131611,1066,Block 1066,53,33.7880538,-84.3981793,53,46,7,46,41,1,0,4,0,0,0
613,131613,1068,Block 1068,54,33.7880895,-84.3971859,54,41,13,41,32,4,0,3,0,1,1
614,131614,1069,Block 1069,73,33.7881375,-84.3962601,73,60,13,60,46,5,0,9,0,0,0
615,131615,1070,Block 1070,62,33.7881171,-84.3951823,62,43,19,43,34,3,0,4,0,1,1
616,131616,1071,Block 1071,2,33.7897951,-84.3948328,2,2,0,2,1,1,0,0,0,0,0
617,131625,1080,Block 1080,19,33.787646,-84.3939013,19,10,9,10,5,0,0,5,0,0,0
618,131627,1082,Block 1082,541,33.788314,-84.388538,541,403,138,403,227,102,0,48,0,10,16
619,131632,2001,Block 2001,75,33.7944431,-84.3730701,75,68,7,68,36,31,0,1,0,0,0
620,131634,2003,Block 2003,69,33.7941424,-84.3761873,69,64,5,64,63,0,1,0,0,0,0
621,131635,2004,Block 2004,27,33.7938599,-84.3780249,27,27,0,27,26,1,0,0,0,0,0
622,131637,2006,Block 2006,27,33.7940402,-84.3799059,27,26,1,26,26,0,0,0,0,0,0
623,131638,2007,Block 2007,76,33.7959891,-84.3825052,76,72,4,72,70,2,0,0,0,0,0
624,131639,2008,Block 2008,41,33.7921483,-84.3757147,41,38,3,38,36,1,0,1,0,0,0
625,131640,2009,Block 2009,29,33.7927563,-84.3738842,29,26,3,26,25,1,0,0,0,0,0
626,131641,2010,Block 2010,79,33.7941976,-84.3825987,79,63,16,63,54,8,1,0,0,0,0
627,131643,2012,Block 2012,1,33.7934441,-84.3787751,1,1,0,1,1,0,0,0,0,0,0
628,131654,3007,Block 3007,1,33.8050048,-84.3785541,1,0,1,0,0,0,0,0,0,0,0
629,131655,3008,Block 3008,43,33.8015302,-84.3761559,43,38,5,38,36,2,0,0,0,0,0
630,131666,3019,Block 3019,45,33.7989288,-84.384853,45,43,2,43,39,3,0,1,0,0,0
631,131667,3020,Block 3020,13,33.7991494,-84.3835847,13,13,0,13,11,0,0,1,0,1,0
632,131668,3021,Block 3021,17,33.8011139,-84.3834156,17,16,1,16,15,1,0,0,0,0,0
633,131669,3022,Block 3022,28,33.8015203,-84.3806609,28,25,3,25,23,0,0,1,0,0,1
634,131670,3023,Block 3023,28,33.7983492,-84.3769767,28,26,2,26,26,0,0,0,0,0,0
635,131671,3024,Block 3024,14,33.8034859,-84.3808697,14,12,2,12,12,0,0,0,0,0,0
636,131679,3032,Block 3032,19,33.7972627,-84.3849894,19,19,0,19,19,0,0,0,0,0,0
637,131680,3033,Block 3033,40,33.7978379,-84.3806211,40,37,3,37,36,1,0,0,0,0,0
638,131681,3034,Block 3034,26,33.7998925,-84.3810348,26,26,0,26,25,1,0,0,0,0,0
639,131683,3036,Block 3036,14,33.798925,-84.3821239,14,13,1,13,11,2,0,0,0,0,0
640,131687,3040,Block 3040,8,33.7984635,-84.388731,8,7,1,7,3,3,0,1,0,0,0
641,131688,3041,Block 3041,26,33.7990485,-84.3881022,26,23,3,23,20,1,0,2,0,0,0
642,131689,3042,Block 3042,32,33.7981822,-84.378236,32,30,2,30,29,1,0,0,0,0,0
643,131690,3043,Block 3043,28,33.7962999,-84.377074,28,26,2,26,26,0,0,0,0,0,0
644,131691,3044,Block 3044,67,33.7971723,-84.3736556,67,64,3,64,62,1,0,0,0,0,1
645,131692,3045,Block 3045,9,33.7976123,-84.3742248,9,8,1,8,7,1,0,0,0,0,0
646,131697,3050,Block 3050,12,33.7964372,-84.3752344,12,12,0,12,11,0,0,1,0,0,0
647,131702,1001,Block 1001,243,33.7914925,-84.4006127,243,222,21,222,87,118,0,12,0,0,5
648,131705,1004,Block 1004,397,33.7882659,-84.4055088,397,340,57,340,89,163,2,67,1,6,12
649,131718,1017,Block 1017,602,33.7892818,-84.4014128,602,458,144,458,235,144,1,63,0,3,12
650,131719,1018,Block 1018,281,33.7874384,-84.4022213,281,238,43,238,74,132,1,17,0,1,13
651,131720,1019,Block 1019,16,33.7890661,-84.3992455,16,16,0,16,10,4,0,1,0,0,1
652,131721,1020,Block 1020,40,33.7880421,-84.3992638,40,36,4,36,20,9,0,7,0,0,0
653,131722,1021,Block 1021,7,33.7868142,-84.3992696,7,5,2,5,3,0,0,2,0,0,0
654,131723,1022,Block 1022,50,33.7849611,-84.3993375,50,45,5,45,18,2,0,23,0,0,2
655,131724,1023,Block 1023,16,33.7853618,-84.4002298,16,13,3,13,3,5,0,5,0,0,0
656,131725,1024,Block 1024,8,33.7853484,-84.4012537,8,5,3,5,3,0,0,2,0,0,0
657,131726,1025,Block 1025,26,33.7853609,-84.4023448,26,22,4,22,12,3,0,6,0,0,1
658,131727,1026,Block 1026,24,33.7853704,-84.4035269,24,23,1,23,19,0,0,3,0,1,0
659,131728,1027,Block 1027,8,33.7853659,-84.4047444,8,7,1,7,7,0,0,0,0,0,0
660,131731,1030,Block 1030,21,33.7840754,-84.4070486,21,17,4,17,10,4,0,1,0,2,0
661,131732,1031,Block 1031,1,33.7845451,-84.4095399,1,1,0,1,0,0,0,1,0,0,0
662,131736,1035,Block 1035,33,33.7840916,-84.4049871,33,29,4,29,19,2,0,8,0,0,0
663,131737,1036,Block 1036,15,33.7837142,-84.4039854,15,13,2,13,8,1,0,4,0,0,0
664,131738,1037,Block 1037,30,33.7837114,-84.4032572,30,27,3,27,19,3,0,5,0,0,0
665,131739,1038,Block 1038,28,33.7837015,-84.4023207,28,17,11,17,9,1,2,1,0,1,3
666,131740,1039,Block 1039,15,33.7836932,-84.4015958,15,13,2,13,7,1,0,5,0,0,0
667,131741,1040,Block 1040,10,33.7840864,-84.4009718,10,6,4,6,4,0,0,2,0,0,0
668,131742,1041,Block 1041,25,33.784085,-84.4002287,25,21,4,21,17,1,0,3,0,0,0
669,131743,1042,Block 1042,28,33.7832514,-84.3997893,28,26,2,26,8,0,0,17,0,0,1
670,131744,1043,Block 1043,10,33.7832652,-84.4009551,10,9,1,9,5,0,0,3,0,1,0
671,131745,1044,Block 1044,6,33.7821923,-84.4009549,6,6,0,6,5,0,0,1,0,0,0
672,131746,1045,Block 1045,24,33.782547,-84.4020388,24,17,7,17,11,0,0,3,0,0,3
673,131747,1046,Block 1046,42,33.782567,-84.4034961,42,35,7,35,14,0,0,20,0,1,0
674,131748,1047,Block 1047,17,33.7829304,-84.4046316,17,15,2,15,10,0,0,5,0,0,0
675,131749,1048,Block 1048,48,33.7825838,-84.4054521,48,31,17,31,14,4,1,11,0,0,1
676,131750,1049,Block 1049,58,33.7830374,-84.4064637,58,46,12,46,24,6,0,12,0,2,2
677,131754,1053,Block 1053,23,33.7818678,-84.4020256,23,15,8,15,14,0,0,1,0,0,0
678,131755,1054,Block 1054,7,33.7818793,-84.4034904,7,6,1,6,5,0,0,1,0,0,0
679,131758,1057,Block 1057,41,33.7821803,-84.3998407,41,37,4,37,21,0,0,14,0,1,1
680,131761,1060,Block 1060,329,33.7819362,-84.4083326,329,222,107,222,127,65,0,20,0,1,9
681,131765,1064,Block 1064,1,33.7841275,-84.4136119,1,1,0,1,0,0,0,1,0,0,0
682,131768,1067,Block 1067,2,33.7811308,-84.4095948,2,1,1,1,0,1,0,0,0,0,0
683,131770,1069,Block 1069,266,33.7820931,-84.4123775,266,258,8,258,134,93,0,11,0,3,17
684,131772,1071,Block 1071,16,33.7810957,-84.4104653,16,16,0,16,14,0,0,2,0,0,0
685,131778,1000,Block 1000,1,33.7777271,-84.4245633,1,1,0,1,1,0,0,0,0,0,0
686,131781,2001,Block 2001,1,33.7857854,-84.4223936,1,1,0,1,1,0,0,0,0,0,0
687,131783,2003,Block 2003,9,33.7849894,-84.4255984,9,8,1,8,8,0,0,0,0,0,0
688,131784,2004,Block 2004,11,33.7848981,-84.4245092,11,10,1,10,10,0,0,0,0,0,0
689,131786,2006,Block 2006,7,33.7848454,-84.4231721,7,7,0,7,6,1,0,0,0,0,0
690,131787,2007,Block 2007,21,33.7834382,-84.4260934,21,17,4,17,17,0,0,0,0,0,0
691,131788,2008,Block 2008,51,33.7827285,-84.4280933,51,45,6,45,32,8,0,1,0,0,4
692,131793,2013,Block 2013,9,33.7744063,-84.4248761,9,7,2,7,7,0,0,0,0,0,0
693,131794,2014,Block 2014,3,33.7748911,-84.4216622,3,2,1,2,0,2,0,0,0,0,0
694,131796,2016,Block 2016,6,33.7801658,-84.4201239,6,3,3,3,0,3,0,0,0,0,0
695,131797,2017,Block 2017,23,33.7834529,-84.4234142,23,23,0,23,16,5,0,2,0,0,0
696,131798,2018,Block 2018,21,33.7834448,-84.4245002,21,17,4,17,12,3,0,1,0,0,1
697,131799,2019,Block 2019,16,33.7812182,-84.424505,16,11,5,11,9,0,0,2,0,0,0
698,131800,2020,Block 2020,19,33.7819239,-84.425589,19,18,1,18,17,0,0,0,0,1,0
699,131801,2021,Block 2021,19,33.7819307,-84.4266472,19,16,3,16,14,1,0,0,0,1,0
700,131802,2022,Block 2022,24,33.7816172,-84.427739,24,23,1,23,19,2,0,1,0,0,1
701,131803,2023,Block 2023,19,33.7815159,-84.4288502,19,17,2,17,16,0,0,1,0,0,0
702,131804,2024,Block 2024,12,33.7801791,-84.4277566,12,10,2,10,10,0,0,0,0,0,0
703,131805,2025,Block 2025,6,33.7809013,-84.4266193,6,6,0,6,4,2,0,0,0,0,0
704,131806,2026,Block 2026,9,33.7808876,-84.4255366,9,9,0,9,8,0,1,0,0,0,0
705,131807,2027,Block 2027,16,33.7803112,-84.4260962,16,13,3,13,9,2,0,2,0,0,0
706,131808,2028,Block 2028,3,33.7798784,-84.4261033,3,2,1,2,1,0,1,0,0,0,0
707,131809,2029,Block 2029,9,33.7804429,-84.4234417,9,8,1,8,8,0,0,0,0,0,0
708,131810,2030,Block 2030,20,33.7819174,-84.4234312,20,18,2,18,14,4,0,0,0,0,0
709,131811,2031,Block 2031,15,33.772216,-84.4180126,15,11,4,11,0,11,0,0,0,0,0
710,131812,2032,Block 2032,11,33.7727048,-84.4194122,11,10,1,10,0,10,0,0,0,0,0
711,131813,2033,Block 2033,18,33.7723071,-84.420682,18,11,7,11,0,11,0,0,0,0,0
712,131814,2034,Block 2034,4,33.7723004,-84.4216369,4,2,2,2,0,2,0,0,0,0,0
713,131815,2035,Block 2035,18,33.7718177,-84.4194307,18,12,6,12,1,11,0,0,0,0,0
714,131818,1000,Block 1000,99,33.7834326,-84.3963698,99,86,13,86,39,9,0,35,0,0,3
715,131819,1001,Block 1001,6,33.7853487,-84.396264,6,6,0,6,4,0,0,2,0,0,0
716,131820,1002,Block 1002,4,33.7849537,-84.3962747,4,4,0,4,2,1,1,0,0,0,0
717,131821,1003,Block 1003,19,33.7851684,-84.3982553,19,19,0,19,14,1,0,4,0,0,0
718,131822,1004,Block 1004,9,33.7837725,-84.398325,9,7,2,7,4,0,0,2,0,1,0
719,131823,1005,Block 1005,57,33.7829011,-84.3983693,57,50,7,50,33,4,1,10,0,0,2
720,131824,1006,Block 1006,24,33.7819749,-84.3984085,24,23,1,23,17,1,0,5,0,0,0
721,131835,2009,Block 2009,1,33.7829718,-84.3885218,1,0,1,0,0,0,0,0,0,0,0
722,131842,2016,Block 2016,419,33.7801062,-84.3880985,419,360,59,360,246,34,1,59,0,8,12
723,131843,2017,Block 2017,96,33.7810666,-84.3883964,96,83,13,83,60,21,0,2,0,0,0
724,131849,2023,Block 2023,133,33.7777934,-84.3880376,133,110,23,110,99,4,0,5,0,0,2
725,131860,1002,Block 1002,2,33.7794931,-84.395512,2,2,0,2,1,0,0,0,0,0,1
726,131862,1004,Block 1004,1,33.7799146,-84.3995409,1,0,1,0,0,0,0,0,0,0,0
727,131863,1005,Block 1005,1,33.7798374,-84.401022,1,0,1,0,0,0,0,0,0,0,0
728,131876,1018,Block 1018,253,33.7784744,-84.4088811,253,44,209,44,18,21,0,2,0,0,3
729,131877,1019,Block 1019,314,33.7774509,-84.4095555,314,272,42,272,119,109,0,22,0,6,16
730,131880,1022,Block 1022,4,33.7768482,-84.4074677,4,0,4,0,0,0,0,0,0,0,0
731,131884,1026,Block 1026,3,33.7759784,-84.392667,3,3,0,3,3,0,0,0,0,0,0
732,131885,1027,Block 1027,2,33.7766722,-84.3928713,2,2,0,2,2,0,0,0,0,0,0
733,131888,1030,Block 1030,1,33.7752673,-84.3913255,1,1,0,1,1,0,0,0,0,0,0
734,131891,1033,Block 1033,1,33.7740436,-84.4071092,1,1,0,1,0,1,0,0,0,0,0
735,131892,1034,Block 1034,5,33.7746365,-84.4067488,5,4,1,4,1,3,0,0,0,0,0
736,131901,1043,Block 1043,9,33.7721765,-84.4034192,9,6,3,6,5,0,0,0,0,0,1
737,131902,1044,Block 1044,12,33.7729884,-84.404411,12,6,6,6,4,0,0,2,0,0,0
738,131907,1000,Block 1000,760,33.7848459,-84.3804369,760,618,142,618,513,41,0,45,0,7,12
739,131912,1005,Block 1005,104,33.786143,-84.3852292,104,71,33,71,59,10,0,2,0,0,0
740,131913,1006,Block 1006,5,33.7861856,-84.3869915,5,0,5,0,0,0,0,0,0,0,0
741,131914,1007,Block 1007,194,33.7850994,-84.3852716,194,117,77,117,65,41,0,3,0,4,4
742,131917,2000,Block 2000,909,33.7859376,-84.3801741,909,771,138,771,585,88,1,59,0,12,26
743,131920,3000,Block 3000,382,33.7827707,-84.3789406,382,351,31,351,303,19,0,20,0,3,6
744,131921,3001,Block 3001,185,33.7837082,-84.3800818,185,173,12,173,140,20,0,8,0,1,4
745,131922,3002,Block 3002,46,33.7836661,-84.381587,46,38,8,38,19,15,0,0,0,0,4
746,131925,3005,Block 3005,424,33.7838356,-84.3839693,424,103,321,103,79,7,0,14,0,1,2
747,131926,3006,Block 3006,105,33.7839246,-84.3853813,105,93,12,93,68,6,0,19,0,0,0
748,131927,3007,Block 3007,113,33.7839153,-84.3870582,113,107,6,107,81,9,0,14,0,1,2
749,131928,3008,Block 3008,1,33.7826141,-84.3870806,1,1,0,1,0,1,0,0,0,0,0
750,131932,3012,Block 3012,230,33.7824156,-84.3813332,230,221,9,221,83,128,1,3,0,1,5
751,131935,1000,Block 1000,71,33.7811767,-84.3785373,71,62,9,62,49,3,2,1,0,0,7
752,131936,1001,Block 1001,93,33.7805935,-84.3801263,93,86,7,86,70,7,1,5,0,0,3
753,131937,1002,Block 1002,268,33.7807004,-84.3816669,268,241,27,241,195,13,2,21,0,5,5
754,131938,1003,Block 1003,143,33.7789539,-84.3819086,143,138,5,138,124,7,0,4,0,0,3
755,131939,1004,Block 1004,65,33.7789027,-84.3803952,65,60,5,60,50,3,1,5,0,0,1
756,131940,1005,Block 1005,46,33.7788542,-84.3790398,46,44,2,44,40,1,0,1,0,1,1
757,131941,1006,Block 1006,95,33.7800348,-84.3785807,95,82,13,82,63,7,0,2,0,0,10
758,131942,1007,Block 1007,31,33.7787994,-84.3780478,31,30,1,30,26,2,0,1,0,1,0
759,131943,1008,Block 1008,33,33.7775165,-84.3781138,33,31,2,31,26,0,0,1,0,0,4
760,131944,1009,Block 1009,47,33.7775971,-84.3791656,47,43,4,43,43,0,0,0,0,0,0
761,131945,1010,Block 1010,88,33.7776873,-84.3805218,88,83,5,83,62,11,0,8,0,0,2
762,131946,1011,Block 1011,160,33.7777882,-84.3820322,160,155,5,155,138,6,1,5,0,2,3
763,131947,1012,Block 1012,59,33.7765987,-84.3821462,59,54,5,54,45,5,0,3,0,0,1
764,131948,1013,Block 1013,46,33.7764967,-84.3806367,46,37,9,37,27,6,0,1,0,0,3
765,131949,1014,Block 1014,44,33.776406,-84.3792801,44,40,4,40,39,0,0,1,0,0,0
766,131950,1015,Block 1015,40,33.7763248,-84.378174,40,34,6,34,30,0,0,3,0,0,1
767,131952,2000,Block 2000,62,33.7751091,-84.3782333,62,53,9,53,45,4,0,1,0,2,1
768,131953,2001,Block 2001,27,33.7751945,-84.379396,27,25,2,25,23,0,0,0,0,0,2
769,131954,2002,Block 2002,73,33.775283,-84.3807544,73,57,16,57,44,8,0,2,0,2,1
770,131955,2003,Block 2003,35,33.7753825,-84.382263,35,31,4,31,25,2,0,3,0,0,1
771,131956,2004,Block 2004,215,33.7741423,-84.3823798,215,201,14,201,80,108,1,6,0,2,4
772,131957,2005,Block 2005,56,33.7740429,-84.3808737,56,51,5,51,27,22,0,0,0,0,2
773,131958,2006,Block 2006,63,33.773587,-84.3795542,63,60,3,60,40,12,0,3,0,3,2
774,131959,2007,Block 2007,90,33.7735143,-84.3783185,90,81,9,81,71,3,0,0,0,4,3
775,131960,2008,Block 2008,169,33.7718966,-84.3784144,169,150,19,150,69,56,3,7,0,1,14
776,131961,2009,Block 2009,156,33.7719235,-84.3797076,156,140,16,140,74,51,1,6,0,0,8
777,131962,2010,Block 2010,82,33.7719053,-84.3810698,82,28,54,28,13,12,0,3,0,0,0
778,131963,2011,Block 2011,43,33.7729778,-84.3810009,43,39,4,39,32,4,0,3,0,0,0
779,131964,2012,Block 2012,242,33.7729904,-84.3825149,242,225,17,225,120,68,2,25,0,5,5
780,131968,1000,Block 1000,1,33.7812517,-84.3832888,1,0,1,0,0,0,0,0,0,0,0
781,131973,1005,Block 1005,2,33.7811285,-84.387008,2,1,1,1,0,0,0,0,0,0,1
782,131976,1008,Block 1008,79,33.780157,-84.3848962,79,66,13,66,64,2,0,0,0,0,0
783,131977,1009,Block 1009,493,33.7801471,-84.3833808,493,438,55,438,362,27,2,40,1,2,4
784,131978,1010,Block 1010,34,33.778999,-84.3834605,34,30,4,30,27,3,0,0,0,0,0
785,131979,1011,Block 1011,245,33.7790572,-84.384978,245,219,26,219,183,15,0,11,0,5,5
786,131982,1014,Block 1014,78,33.7781085,-84.3867873,78,72,6,72,48,7,0,12,0,0,5
787,131984,1016,Block 1016,469,33.7779927,-84.3850885,469,406,63,406,303,25,0,55,0,9,14
788,131985,1017,Block 1017,387,33.7778904,-84.3835758,387,305,82,305,230,18,0,51,0,0,6
789,131986,1018,Block 1018,117,33.7767024,-84.3836885,117,101,16,101,88,5,1,3,0,2,2
790,131987,1019,Block 1019,310,33.7768042,-84.3852021,310,281,29,281,239,13,0,20,0,3,6
791,131988,1020,Block 1020,55,33.776852,-84.3861443,55,48,7,48,39,4,2,3,0,0,0
792,131993,1025,Block 1025,13,33.7754838,-84.3838045,13,11,2,11,10,0,0,0,0,0,1
793,131996,2000,Block 2000,538,33.7743374,-84.3854374,538,448,90,448,163,237,0,34,0,6,8
794,131999,2003,Block 2003,2,33.7730147,-84.3861065,2,2,0,2,1,1,0,0,0,0,0
795,132000,2004,Block 2004,136,33.7729898,-84.3840795,136,123,13,123,60,39,0,21,0,0,3
796,132001,2005,Block 2005,60,33.7718147,-84.3841283,60,45,15,45,37,0,0,4,0,1,3
797,132002,2006,Block 2006,280,33.7717852,-84.3861819,280,230,50,230,145,50,3,24,0,3,5
798,132008,1003,Block 1003,66,33.7811672,-84.373436,66,55,11,55,47,3,0,1,0,2,2
799,132009,1004,Block 1004,109,33.7811722,-84.3758616,109,104,5,104,89,8,0,5,0,0,2
800,132010,1005,Block 1005,72,33.7800313,-84.3758524,72,63,9,63,58,2,0,1,0,0,2
801,132011,1006,Block 1006,17,33.780021,-84.3734311,17,16,1,16,14,2,0,0,0,0,0
802,132012,1007,Block 1007,80,33.7772071,-84.3668689,80,71,9,71,58,8,0,3,0,0,2
803,132013,1008,Block 1008,8,33.7758106,-84.3680682,8,8,0,8,6,1,0,1,0,0,0
804,132014,1009,Block 1009,44,33.7744734,-84.3676976,44,35,9,35,28,4,0,2,0,0,1
805,132015,1010,Block 1010,16,33.7765111,-84.3680851,16,15,1,15,14,0,0,0,0,0,1
806,132016,1011,Block 1011,27,33.7785426,-84.3690119,27,25,2,25,20,2,0,2,1,0,0
807,132017,1012,Block 1012,47,33.777472,-84.3691985,47,44,3,44,40,1,0,3,0,0,0
808,132018,1013,Block 1013,27,33.7761383,-84.3698113,27,26,1,26,22,2,0,0,0,0,2
809,132019,1014,Block 1014,44,33.774616,-84.3696113,44,37,7,37,31,4,0,1,0,1,0
810,132020,1015,Block 1015,69,33.7724412,-84.3706745,69,67,2,67,24,39,1,1,0,0,2
811,132021,1016,Block 1016,288,33.7723533,-84.3688581,288,269,19,269,203,50,1,11,0,0,4
812,132022,1017,Block 1017,123,33.7722268,-84.3660102,123,111,12,111,81,23,2,0,0,2,3
813,132023,1018,Block 1018,108,33.7724087,-84.3720476,108,104,4,104,5,94,0,2,0,1,2
814,132024,1019,Block 1019,39,33.772026,-84.3737077,39,37,2,37,5,32,0,0,0,0,0
815,132025,1020,Block 1020,3,33.7718196,-84.3762747,3,3,0,3,2,0,0,0,0,0,1
816,132027,2000,Block 2000,46,33.778898,-84.3703938,46,43,3,43,32,9,0,0,0,1,1
817,132028,2001,Block 2001,129,33.7783085,-84.3720294,129,120,9,120,99,15,1,1,0,0,4
818,132029,2002,Block 2002,44,33.7789754,-84.3740415,44,41,3,41,37,3,0,0,0,1,0
819,132030,2003,Block 2003,77,33.7786707,-84.3758313,77,69,8,69,52,9,0,4,0,3,1
820,132031,2004,Block 2004,82,33.7786753,-84.3770434,82,72,10,72,61,5,0,2,0,1,3
821,132032,2005,Block 2005,56,33.7770176,-84.3770507,56,51,5,51,45,1,0,4,0,1,0
822,132033,2006,Block 2006,47,33.7770125,-84.3758488,47,43,4,43,38,2,0,1,0,0,2
823,132034,2007,Block 2007,90,33.7771116,-84.3742486,90,82,8,82,69,6,0,4,0,1,2
824,132035,2008,Block 2008,37,33.7778384,-84.3733672,37,35,2,35,33,1,0,0,0,0,1
825,132036,2009,Block 2009,45,33.7776778,-84.3707047,45,42,3,42,33,7,0,2,0,0,0
826,132038,2011,Block 2011,37,33.7762607,-84.3722606,37,33,4,33,29,0,0,3,0,0,1
827,132040,3000,Block 3000,101,33.775029,-84.3716268,101,90,11,90,80,7,0,1,0,0,2
828,132041,3001,Block 3001,66,33.7757459,-84.3740366,66,61,5,61,56,0,0,4,0,0,1
829,132042,3002,Block 3002,75,33.7757599,-84.376489,75,58,17,58,48,5,0,3,0,0,2
830,132043,3003,Block 3003,65,33.7748796,-84.3767765,65,56,9,56,49,5,0,1,0,1,0
831,132044,3004,Block 3004,79,33.7748977,-84.3743257,79,68,11,68,53,8,0,5,0,2,0
832,132045,3005,Block 3005,95,33.7735495,-84.3744613,95,81,14,81,62,12,0,2,0,3,2
833,132046,3006,Block 3006,96,33.7739919,-84.376807,96,77,19,77,62,8,0,3,0,0,4
834,132047,3007,Block 3007,51,33.773003,-84.3767,51,45,6,45,32,7,0,3,0,2,1
835,132050,1000,Block 1000,173,33.7771966,-84.3611782,173,161,12,161,143,5,3,5,0,0,5
836,132051,1001,Block 1001,22,33.777217,-84.3641219,22,21,1,21,21,0,0,0,0,0,0
837,132052,1002,Block 1002,45,33.7772175,-84.3650211,45,43,2,43,42,0,0,1,0,0,0
838,132053,1003,Block 1003,167,33.7752592,-84.3643825,167,163,4,163,132,13,1,9,0,0,8
839,132054,1004,Block 1004,136,33.7759876,-84.3623647,136,119,17,119,96,18,0,3,0,2,0
840,132055,1005,Block 1005,65,33.7760474,-84.359836,65,61,4,61,56,2,0,1,0,0,2
841,132056,1006,Block 1006,61,33.7750257,-84.3598446,61,58,3,58,51,2,1,3,0,1,0
842,132057,1007,Block 1007,65,33.774989,-84.362288,65,53,12,53,47,2,0,4,0,0,0
843,132058,1008,Block 1008,4,33.7741897,-84.3623607,4,3,1,3,3,0,0,0,0,0,0
844,132059,1009,Block 1009,91,33.774212,-84.3598493,91,88,3,88,79,2,0,5,0,0,2
845,132060,1010,Block 1010,36,33.7724538,-84.3632948,36,36,0,36,20,12,1,0,0,2,1
846,132061,1011,Block 1011,76,33.7724864,-84.3616647,76,74,2,74,60,7,0,4,0,0,3
847,132062,1012,Block 1012,29,33.7722935,-84.3604155,29,29,0,29,25,1,1,2,0,0,0
848,132065,2000,Block 2000,7,33.7814905,-84.3594052,7,7,0,7,7,0,0,0,0,0,0
849,132066,2001,Block 2001,5,33.7814074,-84.360725,5,5,0,5,4,0,0,0,0,0,1
850,132067,2002,Block 2002,22,33.781282,-84.3624261,22,20,2,20,20,0,0,0,0,0,0
851,132068,2003,Block 2003,305,33.7802793,-84.3652904,305,295,10,295,251,15,1,19,0,4,5
852,132069,2004,Block 2004,9,33.7781882,-84.3647723,9,9,0,9,8,0,0,1,0,0,0
853,132070,2005,Block 2005,58,33.7782519,-84.361165,58,54,4,54,53,0,0,1,0,0,0
854,132071,2006,Block 2006,70,33.7794632,-84.36148,70,68,2,68,62,3,0,1,0,0,2
855,132072,2007,Block 2007,26,33.7803949,-84.3612741,26,25,1,25,25,0,0,0,0,0,0
856,132073,2008,Block 2008,17,33.7804627,-84.3593659,17,17,0,17,16,0,0,0,0,0,1
857,132076,1000,Block 1000,126,33.7731384,-84.3498595,126,123,3,123,74,43,0,4,0,0,2
858,132077,1001,Block 1001,32,33.7731331,-84.3516358,32,17,15,17,17,0,0,0,0,0,0
859,132079,1003,Block 1003,126,33.7731332,-84.355407,126,111,15,111,97,9,0,1,0,1,3
860,132080,1004,Block 1004,80,33.7725773,-84.3584719,80,75,5,75,63,2,0,3,0,1,6
861,132082,1006,Block 1006,97,33.7717616,-84.35552,97,93,4,93,86,2,1,1,0,2,1
862,132083,1007,Block 1007,42,33.7717534,-84.3531027,42,36,6,36,34,1,0,0,0,0,1
863,132084,1008,Block 1008,114,33.7718789,-84.3520241,114,111,3,111,100,7,0,0,2,0,2
864,132085,1009,Block 1009,49,33.7716237,-84.3512402,49,49,0,49,39,6,0,3,0,1,0
865,132086,1010,Block 1010,64,33.7717558,-84.3498676,64,60,4,60,57,3,0,0,0,0,0
866,132088,2000,Block 2000,41,33.7814442,-84.3512719,41,41,0,41,40,0,0,1,0,0,0
867,132089,2001,Block 2001,48,33.7817,-84.3534824,48,42,6,42,38,1,0,2,0,0,1
868,132091,2003,Block 2003,30,33.7812308,-84.3544272,30,27,3,27,26,0,0,0,1,0,0
869,132092,2004,Block 2004,47,33.7816665,-84.3569958,47,42,5,42,42,0,0,0,0,0,0
870,132093,2005,Block 2005,31,33.780592,-84.3573689,31,28,3,28,23,2,0,2,0,0,1
871,132094,2006,Block 2006,19,33.7808369,-84.3553786,19,19,0,19,19,0,0,0,0,0,0
872,132095,2007,Block 2007,51,33.7797075,-84.3550208,51,48,3,48,42,4,0,2,0,0,0
873,132096,2008,Block 2008,97,33.7786481,-84.3557815,97,87,10,87,81,3,0,2,0,1,0
874,132097,2009,Block 2009,20,33.7796421,-84.3576775,20,20,0,20,19,0,0,1,0,0,0
875,132098,2010,Block 2010,78,33.7803616,-84.3513175,78,71,7,71,64,4,0,2,0,1,0
876,132099,2011,Block 2011,65,33.778476,-84.3508401,65,44,21,44,39,0,0,0,0,4,1
877,132100,2012,Block 2012,111,33.7784707,-84.3491999,111,66,45,66,50,3,1,1,0,11,0
878,132101,2013,Block 2013,37,33.7784896,-84.3498837,37,20,17,20,11,0,1,0,0,6,2
879,132102,2014,Block 2014,88,33.7786422,-84.35221,88,67,21,67,65,0,0,0,0,0,2
880,132104,3000,Block 3000,88,33.77676,-84.3504356,88,84,4,84,80,1,0,2,0,1,0
881,132105,3001,Block 3001,138,33.7773959,-84.3540641,138,132,6,132,119,7,0,3,0,0,3
882,132106,3002,Block 3002,141,33.7774203,-84.3571323,141,128,13,128,115,7,0,3,0,0,3
883,132107,3003,Block 3003,262,33.7760606,-84.3571334,262,243,19,243,212,16,1,5,0,2,7
884,132109,4000,Block 4000,45,33.775871,-84.3504511,45,44,1,44,43,1,0,0,0,0,0
885,132110,4001,Block 4001,179,33.7760569,-84.3540298,179,159,20,159,137,12,0,4,0,3,3
886,132111,4002,Block 4002,330,33.7746211,-84.3540497,330,301,29,301,175,110,2,5,0,2,7
887,132112,4003,Block 4003,40,33.7749403,-84.3507118,40,33,7,33,30,2,0,1,0,0,0
888,132113,4004,Block 4004,40,33.7741406,-84.3507292,40,30,10,30,25,2,0,3,0,0,0
889,132114,4005,Block 4005,142,33.7746195,-84.3571604,142,102,40,102,87,6,0,4,0,0,5
890,132117,1000,Block 1000,45,33.7705138,-84.3498878,45,40,5,40,34,5,0,0,0,1,0
891,132118,1001,Block 1001,17,33.7702524,-84.3517028,17,17,0,17,17,0,0,0,0,0,0
892,132119,1002,Block 1002,47,33.770083,-84.3544957,47,40,7,40,39,0,0,0,0,0,1
893,132120,1003,Block 1003,36,33.7705715,-84.355915,36,36,0,36,31,4,0,0,0,1,0
894,132121,1004,Block 1004,17,33.769665,-84.3576359,17,16,1,16,14,2,0,0,0,0,0
895,132123,1006,Block 1006,18,33.7701631,-84.361568,18,14,4,14,10,2,0,1,0,0,1
896,132125,1008,Block 1008,92,33.7686629,-84.3602447,92,74,18,74,66,3,0,1,0,2,2
897,132126,1009,Block 1009,248,33.7667094,-84.3593902,248,215,33,215,151,44,0,8,0,4,8
898,132132,1015,Block 1015,75,33.7667683,-84.354129,75,71,4,71,40,22,1,0,0,7,1
899,132133,1016,Block 1016,29,33.7658135,-84.3545682,29,27,2,27,23,2,0,0,0,0,2
900,132135,1018,Block 1018,10,33.7695332,-84.3534911,10,10,0,10,10,0,0,0,0,0,0
901,132137,1020,Block 1020,250,33.7631261,-84.3592915,250,240,10,240,199,20,0,12,0,2,7
902,132138,1021,Block 1021,6,33.7636662,-84.3579329,6,6,0,6,6,0,0,0,0,0,0
903,132142,1025,Block 1025,120,33.7654721,-84.3534803,120,117,3,117,103,2,1,3,0,3,5
904,132143,1026,Block 1026,40,33.7668636,-84.3522537,40,37,3,37,32,2,0,1,0,1,1
905,132144,1027,Block 1027,30,33.7678689,-84.3515454,30,28,2,28,25,2,0,1,0,0,0
906,132145,1028,Block 1028,10,33.7690518,-84.3515243,10,10,0,10,10,0,0,0,0,0,0
907,132146,1029,Block 1029,29,33.7689022,-84.3498586,29,25,4,25,23,0,0,1,0,1,0
908,132147,1030,Block 1030,105,33.766327,-84.3502255,105,102,3,102,88,9,0,3,0,1,1
909,132148,1031,Block 1031,168,33.7646268,-84.3520366,168,153,15,153,133,11,0,3,0,1,5
910,132153,1000,Block 1000,22,33.7682915,-84.3637109,22,22,0,22,19,2,0,0,0,0,1
911,132155,1002,Block 1002,36,33.7690071,-84.3659227,36,30,6,30,16,11,0,1,0,0,2
912,132157,1004,Block 1004,26,33.7666727,-84.3662763,26,24,2,24,10,11,0,0,0,1,2
913,132158,1005,Block 1005,22,33.7654017,-84.365843,22,19,3,19,2,16,0,0,0,1,0
914,132159,1006,Block 1006,30,33.7655512,-84.3684637,30,23,7,23,7,16,0,0,0,0,0
915,132160,1007,Block 1007,31,33.7656445,-84.3697604,31,31,0,31,9,21,0,0,0,0,1
916,132161,1008,Block 1008,45,33.7656291,-84.3711794,45,39,6,39,6,31,0,0,0,1,1
917,132162,1009,Block 1009,58,33.7655756,-84.3723432,58,53,5,53,0,53,0,0,0,0,0
918,132163,1010,Block 1010,38,33.7656138,-84.3731007,38,36,2,36,4,31,0,0,0,1,0
919,132164,1011,Block 1011,26,33.7644037,-84.3727678,26,26,0,26,1,25,0,0,0,0,0
920,132165,1012,Block 1012,63,33.7643964,-84.3698797,63,45,18,45,14,29,1,0,0,0,1
921,132166,1013,Block 1013,19,33.7635876,-84.3698777,19,17,2,17,4,12,0,1,0,0,0
922,132168,1015,Block 1015,76,33.7629811,-84.3651839,76,60,16,60,23,23,1,3,0,9,1
923,132169,1016,Block 1016,26,33.7626607,-84.3672335,26,23,3,23,1,15,0,0,0,7,0
924,132170,1017,Block 1017,323,33.7654178,-84.3616558,323,282,41,282,151,98,0,9,0,1,23
925,132171,1018,Block 1018,41,33.7622677,-84.3684902,41,38,3,38,19,18,0,0,0,0,1
926,132172,1019,Block 1019,50,33.7622782,-84.3698272,50,40,10,40,11,23,0,0,0,6,0
927,132175,1022,Block 1022,30,33.7645621,-84.3645843,30,27,3,27,10,15,0,0,0,1,1
928,132177,1024,Block 1024,28,33.7625182,-84.3628779,28,28,0,28,21,5,0,0,0,1,1
929,132178,1025,Block 1025,13,33.7623264,-84.3616313,13,12,1,12,9,2,0,0,0,0,1
930,132181,2000,Block 2000,27,33.7705229,-84.3683238,27,27,0,27,14,11,0,0,0,1,1
931,132182,2001,Block 2001,115,33.7705386,-84.3703732,115,101,14,101,11,85,0,1,0,1,3
932,132183,2002,Block 2002,67,33.7694711,-84.3724121,67,48,19,48,7,37,1,1,0,0,2
933,132184,2003,Block 2003,108,33.7694556,-84.3700226,108,96,12,96,27,64,0,3,0,1,1
934,132185,2004,Block 2004,48,33.7687859,-84.369621,48,41,7,41,21,13,1,3,0,0,3
935,132186,2005,Block 2005,74,33.7671008,-84.3729461,74,74,0,74,0,74,0,0,0,0,0
936,132187,2006,Block 2006,10,33.7671336,-84.3722607,10,10,0,10,0,9,0,1,0,0,0
937,132188,2007,Block 2007,22,33.767843,-84.3715322,22,20,2,20,0,20,0,0,0,0,0
938,132189,2008,Block 2008,12,33.7678258,-84.3707844,12,9,3,9,3,6,0,0,0,0,0
939,132190,2009,Block 2009,49,33.767924,-84.3690317,49,40,9,40,10,24,0,0,0,0,6
940,132191,2010,Block 2010,74,33.7668557,-84.3705164,74,66,8,66,6,60,0,0,0,0,0
941,132192,2011,Block 2011,21,33.766764,-84.3683774,21,14,7,14,4,9,0,0,0,0,1
942,132195,1000,Block 1000,307,33.7651054,-84.3744357,307,263,44,263,35,219,0,3,0,0,6
943,132196,1001,Block 1001,313,33.7655607,-84.3765904,313,274,39,274,135,115,0,15,0,3,6
944,132197,1002,Block 1002,1,33.765826,-84.3799282,1,1,0,1,1,0,0,0,0,0,0
945,132198,1003,Block 1003,185,33.7649022,-84.3830414,185,146,39,146,96,42,0,4,0,1,3
946,132200,1005,Block 1005,1,33.7642362,-84.3840366,1,1,0,1,0,1,0,0,0,0,0
947,132203,1008,Block 1008,1,33.7628019,-84.3834783,1,1,0,1,0,1,0,0,0,0,0
948,132207,1012,Block 1012,439,33.7628819,-84.37576,439,381,58,381,210,147,0,14,0,3,7
949,132208,1013,Block 1013,46,33.7619928,-84.377286,46,43,3,43,22,15,0,2,0,1,3
950,132210,2000,Block 2000,589,33.7705609,-84.3752974,589,569,20,569,41,501,4,3,0,2,18
951,132212,2002,Block 2002,33,33.7688081,-84.3751612,33,30,3,30,0,28,0,0,0,0,2
952,132213,2003,Block 2003,3,33.7689286,-84.3732035,3,3,0,3,0,3,0,0,0,0,0
953,132214,2004,Block 2004,29,33.7681269,-84.3735398,29,28,1,28,3,22,0,0,0,0,3
954,132215,2005,Block 2005,32,33.7671778,-84.3754983,32,27,5,27,4,22,0,1,0,0,0
955,132216,2006,Block 2006,31,33.7669616,-84.3739122,31,26,5,26,3,23,0,0,0,0,0
956,132218,3000,Block 3000,75,33.7706703,-84.3780983,75,63,12,63,32,25,0,3,0,1,2
957,132219,3001,Block 3001,72,33.7708501,-84.3789683,72,65,7,65,33,23,0,6,0,0,3
958,132220,3002,Block 3002,675,33.769859,-84.3800601,675,632,43,632,355,213,0,36,0,5,23
959,132222,3004,Block 3004,170,33.7681485,-84.3798688,170,154,16,154,109,34,0,9,0,1,1
960,132225,1000,Block 1000,125,33.7686979,-84.3912629,125,113,12,113,16,86,1,6,0,0,4
961,132228,1003,Block 1003,2,33.7668224,-84.3896489,2,2,0,2,2,0,0,0,0,0,0
962,132229,1004,Block 1004,248,33.7662923,-84.3924733,248,9,239,9,4,1,0,4,0,0,0
963,132230,1005,Block 1005,61,33.7672149,-84.3924605,61,57,4,57,12,41,0,4,0,0,0
964,132231,1006,Block 1006,30,33.7683428,-84.3924728,30,28,2,28,0,27,0,1,0,0,0
965,132235,2002,Block 2002,127,33.7706032,-84.3844277,127,104,23,104,65,31,0,8,0,0,0
966,132236,2003,Block 2003,4,33.7705525,-84.3862553,4,4,0,4,0,3,0,1,0,0,0
967,132242,2009,Block 2009,84,33.7692009,-84.3846385,84,5,79,5,2,3,0,0,0,0,0
968,132243,2010,Block 2010,155,33.769243,-84.3830206,155,114,41,114,38,67,0,5,0,1,3
969,132244,2011,Block 2011,39,33.7680602,-84.3830436,39,39,0,39,20,15,0,2,0,0,2
970,132245,2012,Block 2012,10,33.7680064,-84.3847056,10,9,1,9,8,1,0,0,0,0,0
971,132246,2013,Block 2013,1,33.7662352,-84.3847024,1,1,0,1,0,0,0,1,0,0,0
972,132247,2014,Block 2014,254,33.7665083,-84.3830616,254,219,35,219,68,138,0,6,0,1,6
973,132251,2018,Block 2018,15,33.7687202,-84.3881407,15,14,1,14,9,5,0,0,0,0,0
974,132255,2022,Block 2022,1,33.7666836,-84.3859082,1,1,0,1,0,0,0,1,0,0,0
975,132258,2025,Block 2025,1,33.7677516,-84.3875708,1,1,0,1,0,0,0,0,0,1,0
976,132264,2031,Block 2031,1,33.7669234,-84.3886189,1,1,0,1,0,1,0,0,0,0,0
977,132267,2034,Block 2034,516,33.7654989,-84.3881602,516,318,198,318,95,169,2,38,0,4,10
978,132268,2035,Block 2035,74,33.7652318,-84.389824,74,3,71,3,3,0,0,0,0,0,0
979,132273,2040,Block 2040,120,33.7633049,-84.3850768,120,110,10,110,19,86,0,0,0,0,5
980,132280,2047,Block 2047,25,33.7636168,-84.3870493,25,18,7,18,12,6,0,0,0,0,0
981,132281,2048,Block 2048,3,33.7636578,-84.388264,3,2,1,2,2,0,0,0,0,0,0
982,132284,2051,Block 2051,316,33.7627871,-84.3882774,316,179,137,179,74,87,2,4,0,2,10
983,132297,1000,Block 1000,365,33.7698557,-84.3942966,365,120,245,120,15,95,0,4,0,1,5
984,132298,1001,Block 1001,11,33.7690557,-84.3973796,11,8,3,8,2,5,0,1,0,0,0
985,132299,1002,Block 1002,95,33.7669562,-84.3981875,95,80,15,80,63,10,0,2,0,2,3
986,132303,1006,Block 1006,10,33.7628115,-84.3971322,10,8,2,8,6,2,0,0,0,0,0
987,132305,1008,Block 1008,1,33.7650052,-84.3967322,1,1,0,1,0,0,0,0,0,0,1
988,132306,1009,Block 1009,1,33.7655854,-84.3967204,1,1,0,1,0,1,0,0,0,0,0
989,132307,1010,Block 1010,104,33.7659902,-84.3957243,104,82,22,82,19,54,0,8,0,0,1
990,132308,1011,Block 1011,91,33.7672415,-84.3957151,91,76,15,76,10,58,0,4,0,1,3
991,132309,1012,Block 1012,86,33.7672324,-84.3941768,86,78,8,78,12,61,0,5,0,0,0
992,132310,1013,Block 1013,36,33.7683693,-84.3937629,36,31,5,31,8,19,0,2,0,1,1
993,132312,1015,Block 1015,1,33.7635003,-84.3940148,1,1,0,1,1,0,0,0,0,0,0
994,132313,1016,Block 1016,1,33.7649916,-84.3924797,1,1,0,1,1,0,0,0,0,0,0
995,132320,1023,Block 1023,101,33.7643033,-84.3909418,101,83,18,83,44,34,0,0,0,1,4
996,132322,1025,Block 1025,155,33.7628047,-84.3912823,155,132,23,132,64,59,0,4,0,1,4
997,132327,1030,Block 1030,93,33.7610689,-84.3949581,93,62,31,62,29,26,0,5,0,1,1
998,132333,1036,Block 1036,131,33.7659809,-84.3941887,131,119,12,119,9,101,0,7,0,1,1
999,132339,1000,Block 1000,22,33.7666613,-84.4093875,22,9,13,9,0,9,0,0,0,0,0
1000,132340,1001,Block 1001,19,33.7668352,-84.4105564,19,6,13,6,0,6,0,0,0,0,0
1001,132341,1002,Block 1002,27,33.7668468,-84.4118794,27,8,19,8,0,8,0,0,0,0,0
1002,132342,1003,Block 1003,10,33.7668718,-84.4132078,10,8,2,8,0,7,0,0,0,0,1
1003,132343,1004,Block 1004,27,33.7656732,-84.413214,27,11,16,11,0,9,0,0,0,0,2
1004,132344,1005,Block 1005,110,33.7653146,-84.4118866,110,34,76,34,0,34,0,0,0,0,0
1005,132345,1006,Block 1006,29,33.7653166,-84.4105751,29,15,14,15,0,15,0,0,0,0,0
1006,132346,1007,Block 1007,31,33.7651379,-84.4094129,31,13,18,13,0,13,0,0,0,0,0
1007,132347,1008,Block 1008,10,33.7638451,-84.409434,10,2,8,2,0,2,0,0,0,0,0
1008,132348,1009,Block 1009,5,33.7638428,-84.4105999,5,4,1,4,0,4,0,0,0,0,0
1009,132349,1010,Block 1010,9,33.7638456,-84.4118996,9,6,3,6,0,6,0,0,0,0,0
1010,132350,1011,Block 1011,22,33.7641959,-84.4132318,22,12,10,12,0,10,0,0,0,0,2
1011,132352,2000,Block 2000,38,33.7691659,-84.4149993,38,19,19,19,0,18,0,0,0,1,0
1012,132353,2001,Block 2001,15,33.7693833,-84.4159911,15,10,5,10,0,10,0,0,0,0,0
1013,132354,2002,Block 2002,47,33.7682433,-84.4169564,47,19,28,19,0,18,0,0,0,0,1
1014,132355,2003,Block 2003,20,33.7680438,-84.4160092,20,10,10,10,2,8,0,0,0,0,0
1015,132356,2004,Block 2004,6,33.7678087,-84.4150165,6,3,3,3,0,3,0,0,0,0,0
1016,132357,2005,Block 2005,3,33.7666793,-84.4160227,3,0,3,0,0,0,0,0,0,0,0
1017,132358,2006,Block 2006,3,33.7671428,-84.416025,3,2,1,2,0,1,0,0,0,0,1
1018,132359,2007,Block 2007,11,33.7669054,-84.4151221,11,6,5,6,0,6,0,0,0,0,0
1019,132360,2008,Block 2008,15,33.766891,-84.4142574,15,8,7,8,0,8,0,0,0,0,0
1020,132361,2009,Block 2009,10,33.7656862,-84.4142746,10,4,6,4,0,4,0,0,0,0,0
1021,132362,2010,Block 2010,25,33.7659504,-84.415142,25,19,6,19,1,16,0,0,0,0,2
1022,132363,2011,Block 2011,25,33.765713,-84.4160325,25,9,16,9,0,9,0,0,0,0,0
1023,132364,2012,Block 2012,30,33.7657183,-84.4169661,30,12,18,12,0,12,0,0,0,0,0
1024,132365,2013,Block 2013,29,33.766766,-84.4185003,29,23,6,23,0,23,0,0,0,0,0
1025,132366,2014,Block 2014,16,33.7661223,-84.4179553,16,6,10,6,0,6,0,0,0,0,0
1026,132367,2015,Block 2015,29,33.7655873,-84.4186853,29,19,10,19,0,19,0,0,0,0,0
1027,132368,2016,Block 2016,22,33.7646363,-84.418529,22,12,10,12,0,12,0,0,0,0,0
1028,132369,2017,Block 2017,8,33.7642227,-84.4165344,8,5,3,5,0,5,0,0,0,0,0
1029,132370,2018,Block 2018,26,33.7642064,-84.4151776,26,21,5,21,0,21,0,0,0,0,0
1030,132371,2019,Block 2019,5,33.7652154,-84.4151497,5,0,5,0,0,0,0,0,0,0,0
1031,132372,2020,Block 2020,12,33.7642031,-84.4143023,12,6,6,6,0,6,0,0,0,0,0
1032,132373,2021,Block 2021,13,33.7638876,-84.418537,13,6,7,6,0,6,0,0,0,0,0
1033,132375,3000,Block 3000,25,33.7709331,-84.4180222,25,3,22,3,0,3,0,0,0,0,0
1034,132376,3001,Block 3001,11,33.7709346,-84.419108,11,6,5,6,0,6,0,0,0,0,0
1035,132377,3002,Block 3002,12,33.7709394,-84.4200003,12,8,4,8,2,5,1,0,0,0,0
1036,132378,3003,Block 3003,7,33.770938,-84.4206907,7,1,6,1,0,1,0,0,0,0,0
1037,132379,3004,Block 3004,32,33.7698898,-84.4218823,32,16,16,16,1,15,0,0,0,0,0
1038,132380,3005,Block 3005,30,33.7696946,-84.4200074,30,14,16,14,3,10,0,0,0,0,1
1039,132383,3008,Block 3008,38,33.7680052,-84.4184887,38,28,10,28,2,26,0,0,0,0,0
1040,132384,3009,Block 3009,44,33.7696967,-84.4180264,44,29,15,29,3,26,0,0,0,0,0
1041,132385,3010,Block 3010,27,33.769695,-84.4191055,27,12,15,12,0,12,0,0,0,0,0
1042,132387,3012,Block 3012,56,33.7646053,-84.4240455,56,37,19,37,2,35,0,0,0,0,0
1043,132389,3014,Block 3014,132,33.7653679,-84.4228321,132,43,89,43,1,39,1,0,0,1,1
1044,132390,3015,Block 3015,79,33.7663797,-84.4211755,79,40,39,40,0,39,0,0,0,0,1
1045,132391,3016,Block 3016,9,33.7657307,-84.4202803,9,8,1,8,1,7,0,0,0,0,0
1046,132392,3017,Block 3017,23,33.764238,-84.4214693,23,12,11,12,1,11,0,0,0,0,0
1047,132393,3018,Block 3018,28,33.764238,-84.4202888,28,14,14,14,0,14,0,0,0,0,0
1048,132396,1000,Block 1000,44,33.7629105,-84.4193991,44,24,20,24,1,23,0,0,0,0,0
1049,132397,1001,Block 1001,23,33.7629088,-84.4226745,23,14,9,14,0,14,0,0,0,0,0
1050,132399,1003,Block 1003,37,33.7613002,-84.4210787,37,25,12,25,0,25,0,0,0,0,0
1051,132400,1004,Block 1004,8,33.7619466,-84.4231657,8,3,5,3,0,3,0,0,0,0,0
1052,132402,1006,Block 1006,22,33.7609112,-84.4231771,22,16,6,16,2,14,0,0,0,0,0
1053,132403,1007,Block 1007,16,33.7605796,-84.4215965,16,12,4,12,0,11,0,1,0,0,0
1054,132404,1008,Block 1008,20,33.7599946,-84.4206001,20,17,3,17,1,16,0,0,0,0,0
1055,132405,1009,Block 1009,20,33.7601657,-84.4195431,20,14,6,14,2,11,0,0,0,0,1
1056,132406,1010,Block 1010,47,33.7606735,-84.4182119,47,30,17,30,1,28,0,0,0,0,1
1057,132407,1011,Block 1011,31,33.7620084,-84.4203823,31,16,15,16,0,15,0,0,0,0,1
1058,132408,1012,Block 1012,36,33.759444,-84.4224721,36,22,14,22,0,22,0,0,0,0,0
1059,132412,1016,Block 1016,141,33.7580931,-84.4195059,141,49,92,49,1,47,0,0,0,0,1
1060,132413,1017,Block 1017,40,33.7591549,-84.4198007,40,24,16,24,2,21,0,0,0,0,1
1061,132414,1018,Block 1018,10,33.7571873,-84.4185764,10,7,3,7,0,7,0,0,0,0,0
1062,132415,1019,Block 1019,24,33.7569485,-84.419988,24,17,7,17,1,16,0,0,0,0,0
1063,132416,1020,Block 1020,30,33.7557057,-84.4208478,30,22,8,22,1,21,0,0,0,0,0
1064,132417,1021,Block 1021,23,33.7565665,-84.423304,23,18,5,18,0,17,0,0,0,0,1
1065,132418,1022,Block 1022,25,33.7561041,-84.4232359,25,14,11,14,1,12,0,0,0,0,1
1066,132419,1023,Block 1023,74,33.7552425,-84.4233689,74,43,31,43,0,42,1,0,0,0,0
1067,132420,1024,Block 1024,21,33.7543394,-84.4250164,21,14,7,14,0,14,0,0,0,0,0
1068,132421,1025,Block 1025,25,33.7560984,-84.4189549,25,21,4,21,1,19,0,0,0,0,1
1069,132422,1026,Block 1026,3,33.7551531,-84.4189635,3,3,0,3,0,3,0,0,0,0,0
1070,132424,2000,Block 2000,39,33.7630311,-84.4258035,39,17,22,17,0,16,0,0,0,0,1
1071,132425,2001,Block 2001,96,33.75999,-84.4265445,96,39,57,39,3,36,0,0,0,0,0
1072,132426,2002,Block 2002,39,33.7588974,-84.4267781,39,28,11,28,0,28,0,0,0,0,0
1073,132427,2003,Block 2003,17,33.758261,-84.4259797,17,10,7,10,0,10,0,0,0,0,0
1074,132428,2004,Block 2004,28,33.757161,-84.4270508,28,24,4,24,0,22,0,0,0,0,2
1075,132429,2005,Block 2005,62,33.7617834,-84.4259832,62,33,29,33,0,32,0,0,0,0,1
1076,132430,2006,Block 2006,63,33.7608142,-84.4285623,63,41,22,41,0,40,0,0,0,0,1
1077,132431,2007,Block 2007,64,33.7598992,-84.430266,64,42,22,42,1,41,0,0,0,0,0
1078,132432,2008,Block 2008,4,33.7567489,-84.4286283,4,3,1,3,0,3,0,0,0,0,0
1079,132434,2010,Block 2010,11,33.7561776,-84.4269707,11,6,5,6,0,6,0,0,0,0,0
1080,132435,2011,Block 2011,9,33.7558172,-84.4293339,9,6,3,6,0,6,0,0,0,0,0
1081,132436,2012,Block 2012,9,33.7556518,-84.4303234,9,5,4,5,1,4,0,0,0,0,0
1082,132437,2013,Block 2013,45,33.7544744,-84.4304921,45,28,17,28,0,28,0,0,0,0,0
1083,132438,2014,Block 2014,15,33.7550926,-84.4327602,15,4,11,4,0,4,0,0,0,0,0
1084,132439,2015,Block 2015,30,33.755323,-84.428522,30,18,12,18,0,16,0,0,0,0,2
1085,132440,2016,Block 2016,29,33.7554941,-84.4271358,29,20,9,20,0,20,0,0,0,0,0
1086,132441,2017,Block 2017,26,33.7545877,-84.4266833,26,23,3,23,2,20,0,0,0,0,1
1087,132442,2018,Block 2018,14,33.761615,-84.4246587,14,9,5,9,0,9,0,0,0,0,0
1088,132443,2019,Block 2019,11,33.7542284,-84.4327222,11,9,2,9,0,9,0,0,0,0,0
1089,132446,1000,Block 1000,9,33.762995,-84.4119168,9,4,5,4,0,4,0,0,0,0,0
1090,132447,1001,Block 1001,23,33.7626531,-84.4132477,23,20,3,20,0,18,0,0,0,0,2
1091,132448,1002,Block 1002,55,33.7619833,-84.414526,55,22,33,22,0,22,0,0,0,0,0
1092,132449,1003,Block 1003,26,33.7628488,-84.4162979,26,16,10,16,0,15,1,0,0,0,0
1093,132450,1004,Block 1004,105,33.7613312,-84.4163161,105,62,43,62,2,60,0,0,0,0,0
1094,132451,1005,Block 1005,15,33.7601038,-84.4160968,15,8,7,8,1,7,0,0,0,0,0
1095,132452,1006,Block 1006,14,33.7601356,-84.4136476,14,2,12,2,0,1,0,1,0,0,0
1096,132454,1008,Block 1008,10,33.7615101,-84.4132769,10,6,4,6,1,5,0,0,0,0,0
1097,132455,1009,Block 1009,18,33.7608145,-84.4133459,18,9,9,9,0,9,0,0,0,0,0
1098,132456,1010,Block 1010,16,33.7594292,-84.4165888,16,8,8,8,0,7,0,0,0,0,1
1099,132457,1011,Block 1011,87,33.758866,-84.4159657,87,71,16,71,0,69,0,0,0,0,2
1100,132458,1012,Block 1012,99,33.7589763,-84.4136459,99,80,19,80,2,75,1,0,0,0,2
1101,132459,1013,Block 1013,3,33.759515,-84.4119884,3,2,1,2,0,2,0,0,0,0,0
1102,132460,1014,Block 1014,16,33.7583777,-84.4150744,16,9,7,9,0,9,0,0,0,0,0
1103,132461,1015,Block 1015,77,33.7576247,-84.4150953,77,59,18,59,0,59,0,0,0,0,0
1104,132462,1016,Block 1016,43,33.7573235,-84.4161921,43,31,12,31,1,30,0,0,0,0,0
1105,132464,1018,Block 1018,116,33.7572724,-84.4136937,116,92,24,92,0,89,0,0,0,2,1
1106,132466,1020,Block 1020,46,33.7556569,-84.4143149,46,32,14,32,3,24,0,2,0,1,2
1107,132468,1022,Block 1022,151,33.755506,-84.4166404,151,17,134,17,1,16,0,0,0,0,0
1108,132471,2001,Block 2001,35,33.7624662,-84.4094161,35,20,15,20,1,19,0,0,0,0,0
1109,132472,2002,Block 2002,58,33.7612103,-84.4106091,58,42,16,42,2,39,0,0,0,0,1
1110,132473,2003,Block 2003,7,33.7590467,-84.4094035,7,6,1,6,0,6,0,0,0,0,0
1111,132474,2004,Block 2004,3,33.7596817,-84.4094023,3,2,1,2,0,1,0,0,0,0,1
1112,132475,2005,Block 2005,20,33.7607851,-84.4094096,20,17,3,17,1,16,0,0,0,0,0
1113,132478,2008,Block 2008,12,33.7590051,-84.4083322,12,12,0,12,0,11,1,0,0,0,0
1114,132479,2009,Block 2009,22,33.7584376,-84.4089385,22,20,2,20,0,20,0,0,0,0,0
1115,132480,2010,Block 2010,19,33.7585516,-84.4106516,19,12,7,12,1,9,1,0,0,1,0
1116,132481,2011,Block 2011,24,33.758576,-84.4120289,24,21,3,21,1,20,0,0,0,0,0
1117,132482,2012,Block 2012,28,33.7572297,-84.4120484,28,15,13,15,0,15,0,0,0,0,0
1118,132483,2013,Block 2013,15,33.7571465,-84.4107229,15,13,2,13,0,13,0,0,0,0,0
1119,132484,2014,Block 2014,19,33.7578245,-84.4088783,19,14,5,14,0,14,0,0,0,0,0
1120,132485,2015,Block 2015,23,33.7572339,-84.4089352,23,19,4,19,1,18,0,0,0,0,0
1121,132489,2019,Block 2019,23,33.7555604,-84.4122701,23,16,7,16,0,14,0,1,0,0,1
1122,132497,1005,Block 1005,6,33.763099,-84.4057926,6,6,0,6,0,6,0,0,0,0,0
1123,132498,1006,Block 1006,6,33.7631061,-84.4070717,6,4,2,4,0,3,0,0,0,0,1
1124,132500,1008,Block 1008,14,33.7619839,-84.4057899,14,12,2,12,0,11,0,0,0,0,1
1125,132508,1016,Block 1016,7,33.7590469,-84.4035193,7,5,2,5,0,4,0,0,0,1,0
1126,132510,1018,Block 1018,7,33.7606177,-84.4050304,7,7,0,7,0,7,0,0,0,0,0
1127,132511,1019,Block 1019,24,33.7606303,-84.4058648,24,11,13,11,0,11,0,0,0,0,0
1128,132512,1020,Block 1020,38,33.7606471,-84.4070897,38,32,6,32,0,31,0,0,0,0,1
1129,132514,1022,Block 1022,3,33.758265,-84.4048102,3,1,2,1,0,1,0,0,0,0,0
1130,132515,1023,Block 1023,18,33.7588635,-84.4048055,18,4,14,4,0,4,0,0,0,0,0
1131,132516,1024,Block 1024,9,33.7596395,-84.4047999,9,8,1,8,1,7,0,0,0,0,0
1132,132517,1025,Block 1025,1,33.759644,-84.4054327,1,0,1,0,0,0,0,0,0,0,0
1133,132519,1027,Block 1027,12,33.7596533,-84.4068118,12,7,5,7,0,7,0,0,0,0,0
1134,132520,1028,Block 1028,4,33.7596627,-84.4075141,4,3,1,3,0,3,0,0,0,0,0
1135,132521,1029,Block 1029,11,33.7586632,-84.4075276,11,7,4,7,2,5,0,0,0,0,0
1136,132522,1030,Block 1030,7,33.7586586,-84.4068219,7,5,2,5,0,5,0,0,0,0,0
1137,132523,1031,Block 1031,21,33.7586401,-84.405866,21,8,13,8,0,7,0,0,0,1,0
1138,132524,1032,Block 1032,23,33.7574706,-84.4058836,23,1,22,1,0,1,0,0,0,0,0
1139,132525,1033,Block 1033,12,33.7577963,-84.4071105,12,9,3,9,1,8,0,0,0,0,0
1140,132526,1034,Block 1034,20,33.7572121,-84.4071178,20,16,4,16,1,14,0,0,0,1,0
1141,132527,1035,Block 1035,9,33.7566622,-84.406228,9,1,8,1,0,1,0,0,0,0,0
1142,132528,1036,Block 1036,37,33.7574538,-84.404837,37,0,37,0,0,0,0,0,0,0,0
1143,132549,1057,Block 1057,306,33.7554417,-84.4040679,306,274,32,274,3,265,0,0,0,1,5
1144,132552,1000,Block 1000,108,33.7608654,-84.3753385,108,105,3,105,58,38,0,8,0,1,0
1145,132564,1012,Block 1012,605,33.7588753,-84.3761033,605,153,452,153,57,90,0,1,0,3,2
1146,132570,1018,Block 1018,193,33.7603048,-84.3815311,193,155,38,155,79,62,1,8,1,4,0
1147,132573,1021,Block 1021,10,33.7577439,-84.3832245,10,5,5,5,2,3,0,0,0,0,0
1148,132579,1027,Block 1027,181,33.7563982,-84.3812051,181,174,7,174,2,169,0,0,0,0,3
1149,132580,1028,Block 1028,2,33.7563346,-84.3832479,2,0,2,0,0,0,0,0,0,0,0
1150,132581,1029,Block 1029,1,33.7550066,-84.3832692,1,1,0,1,0,1,0,0,0,0,0
1151,132582,1030,Block 1030,209,33.7549838,-84.3812415,209,63,146,63,13,42,3,0,0,0,5
1152,132586,2000,Block 2000,18,33.7568153,-84.3754607,18,13,5,13,2,10,0,0,0,1,0
1153,132587,2001,Block 2001,28,33.7568498,-84.3772598,28,18,10,18,1,17,0,0,0,0,0
1154,132589,2003,Block 2003,3,33.7557438,-84.3772767,3,1,2,1,0,1,0,0,0,0,0
1155,132590,2004,Block 2004,5,33.7557189,-84.3754875,5,4,1,4,0,4,0,0,0,0,0
1156,132591,2005,Block 2005,209,33.7549208,-84.3749617,209,180,29,180,3,174,0,1,0,0,2
1157,132593,2007,Block 2007,6,33.7549375,-84.3774365,6,0,6,0,0,0,0,0,0,0,0
1158,132595,2009,Block 2009,1,33.7549655,-84.3790203,1,1,0,1,0,1,0,0,0,0,0
1159,132599,1000,Block 1000,375,33.7605285,-84.3641897,375,350,25,350,275,35,2,22,1,4,11
1160,132600,1001,Block 1001,35,33.7604204,-84.3659198,35,32,3,32,20,11,0,0,0,1,0
1161,132601,1002,Block 1002,42,33.7603959,-84.3666881,42,30,12,30,18,5,0,0,0,7,0
1162,132603,1004,Block 1004,1,33.7612204,-84.367605,1,1,0,1,1,0,0,0,0,0,0
1163,132604,1005,Block 1005,33,33.7600303,-84.3690913,33,24,9,24,3,18,0,0,0,0,3
1164,132605,1006,Block 1006,23,33.760889,-84.3702734,23,19,4,19,6,9,0,0,0,2,2
1165,132606,1007,Block 1007,257,33.7608016,-84.3731865,257,237,20,237,91,127,1,10,0,1,7
1166,132608,1009,Block 1009,1,33.7598385,-84.3732144,1,1,0,1,1,0,0,0,0,0,0
1167,132609,1010,Block 1010,142,33.7597238,-84.3710011,142,113,29,113,66,39,1,2,0,2,3
1168,132610,1011,Block 1011,40,33.7590114,-84.36674,40,36,4,36,12,16,1,3,0,0,4
1169,132611,1012,Block 1012,35,33.7602531,-84.3674664,35,21,14,21,10,3,0,4,0,4,0
1170,132613,1014,Block 1014,84,33.7584892,-84.3710349,84,54,30,54,3,49,0,0,0,0,2
1171,132616,1017,Block 1017,31,33.7567479,-84.3694569,31,27,4,27,13,14,0,0,0,0,0
1172,132617,1018,Block 1018,27,33.7567109,-84.3684465,27,21,6,21,15,5,0,1,0,0,0
1173,132618,1019,Block 1019,20,33.7571616,-84.3670489,20,19,1,19,11,6,0,1,0,0,1
1174,132619,1020,Block 1020,57,33.758066,-84.3667661,57,39,18,39,25,13,0,1,0,0,0
1175,132620,1021,Block 1021,39,33.7586219,-84.3650626,39,35,4,35,25,3,0,1,0,3,3
1176,132621,1022,Block 1022,103,33.7561401,-84.3660104,103,48,55,48,34,12,0,0,0,1,1
1177,132622,1023,Block 1023,7,33.756333,-84.3675919,7,7,0,7,4,3,0,0,0,0,0
1178,132623,1024,Block 1024,1,33.7559961,-84.367327,1,1,0,1,0,1,0,0,0,0,0
1179,132624,1025,Block 1025,19,33.75485,-84.3670161,19,17,2,17,4,12,0,1,0,0,0
1180,132625,1026,Block 1026,63,33.7550165,-84.3688589,63,56,7,56,38,14,0,3,0,0,1
1181,132627,1028,Block 1028,8,33.755716,-84.369674,8,8,0,8,4,4,0,0,0,0,0
1182,132628,1029,Block 1029,15,33.7556653,-84.3705218,15,5,10,5,3,2,0,0,0,0,0
1183,132629,1030,Block 1030,44,33.756755,-84.3705109,44,38,6,38,13,23,0,0,1,1,0
1184,132630,1031,Block 1031,23,33.7567667,-84.3715835,23,19,4,19,8,9,1,0,0,0,1
1185,132631,1032,Block 1032,1,33.7565766,-84.3732349,1,1,0,1,1,0,0,0,0,0,0
1186,132633,1034,Block 1034,29,33.7548788,-84.37095,29,18,11,18,10,6,0,2,0,0,0
1187,132634,1035,Block 1035,9,33.7556754,-84.3715949,9,5,4,5,2,3,0,0,0,0,0
1188,132638,1000,Block 1000,87,33.7615731,-84.3589996,87,84,3,84,65,14,0,3,0,1,1
1189,132639,1001,Block 1001,480,33.7593945,-84.3626309,480,449,31,449,355,48,1,24,0,5,16
1190,132641,1003,Block 1003,43,33.7597989,-84.3604694,43,42,1,42,38,2,0,2,0,0,0
1191,132642,1004,Block 1004,51,33.7587989,-84.3606542,51,45,6,45,42,3,0,0,0,0,0
1192,132643,1005,Block 1005,108,33.7586194,-84.35875,108,96,12,96,88,5,0,2,0,0,1
1193,132644,1006,Block 1006,23,33.7583263,-84.3599769,23,22,1,22,21,0,0,1,0,0,0
1194,132645,1007,Block 1007,96,33.7572888,-84.3616477,96,85,11,85,73,9,0,2,0,0,1
1195,132646,1008,Block 1008,12,33.7578797,-84.363291,12,9,3,9,8,1,0,0,0,0,0
1196,132647,1009,Block 1009,15,33.7561155,-84.3637353,15,15,0,15,14,0,0,1,0,0,0
1197,132649,1011,Block 1011,21,33.7560977,-84.3607624,21,20,1,20,18,2,0,0,0,0,0
1198,132650,1012,Block 1012,5,33.7564521,-84.3596565,5,5,0,5,5,0,0,0,0,0,0
1199,132651,1013,Block 1013,18,33.756455,-84.3581268,18,18,0,18,17,1,0,0,0,0,0
1200,132652,1014,Block 1014,1,33.7558642,-84.3594726,1,1,0,1,1,0,0,0,0,0,0
1201,132654,1016,Block 1016,64,33.7558852,-84.3623219,64,49,15,49,35,12,0,0,0,0,2
1202,132657,2001,Block 2001,21,33.7631491,-84.3505414,21,20,1,20,19,1,0,0,0,0,0
1203,132658,2002,Block 2002,42,33.7632375,-84.3534385,42,38,4,38,36,1,0,0,0,0,1
1204,132659,2003,Block 2003,15,33.7641661,-84.3546204,15,14,1,14,12,0,0,2,0,0,0
1205,132660,2004,Block 2004,32,33.7629987,-84.3564083,32,27,5,27,27,0,0,0,0,0,0
1206,132661,2005,Block 2005,22,33.760912,-84.3574047,22,21,1,21,20,0,0,1,0,0,0
1207,132662,2006,Block 2006,26,33.7617598,-84.3553599,26,26,0,26,20,5,0,1,0,0,0
1208,132663,2007,Block 2007,6,33.7627204,-84.3547619,6,6,0,6,5,0,0,1,0,0,0
1209,132665,2009,Block 2009,50,33.7615015,-84.3515839,50,44,6,44,38,4,0,1,0,0,1
1210,132667,2011,Block 2011,72,33.7600085,-84.3533358,72,71,1,71,64,3,0,1,0,0,3
1211,132669,2013,Block 2013,11,33.7605715,-84.3556349,11,11,0,11,11,0,0,0,0,0,0
1212,132670,2014,Block 2014,21,33.7596183,-84.3565497,21,18,3,18,18,0,0,0,0,0,0
1213,132671,2015,Block 2015,7,33.758758,-84.3572779,7,6,1,6,6,0,0,0,0,0,0
1214,132673,2017,Block 2017,4,33.7569153,-84.3569614,4,3,1,3,3,0,0,0,0,0,0
1215,132674,2018,Block 2018,9,33.7573216,-84.3563093,9,8,1,8,7,0,0,0,0,0,1
1216,132675,2019,Block 2019,68,33.7580642,-84.3552894,68,63,5,63,50,5,0,2,0,1,5
1217,132677,2021,Block 2021,2,33.7567471,-84.3544932,2,2,0,2,2,0,0,0,0,0,0
1218,132681,2025,Block 2025,12,33.7552637,-84.3581113,12,10,2,10,7,3,0,0,0,0,0
1219,132682,2026,Block 2026,68,33.7559071,-84.356173,68,57,11,57,42,9,0,5,0,0,1
1220,132683,2027,Block 2027,63,33.7544591,-84.3620829,63,62,1,62,45,10,0,4,0,0,3
1221,132684,2028,Block 2028,40,33.7546593,-84.3601787,40,36,4,36,35,0,0,0,1,0,0
1222,132685,2029,Block 2029,16,33.7541817,-84.3634115,16,16,0,16,16,0,0,0,0,0,0
1223,132686,2030,Block 2030,6,33.753766,-84.3650104,6,6,0,6,3,3,0,0,0,0,0
1224,132687,2031,Block 2031,15,33.7602969,-84.3502495,15,14,1,14,14,0,0,0,0,0,0
1225,132688,2032,Block 2032,74,33.7598654,-84.3516781,74,70,4,70,57,9,0,0,0,0,4
1226,132691,2035,Block 2035,16,33.7551995,-84.3606747,16,16,0,16,13,3,0,0,0,0,0
1227,132692,2036,Block 2036,13,33.7554954,-84.3593751,13,11,2,11,9,2,0,0,0,0,0
1228,132695,1000,Block 1000,25,33.7513006,-84.3498319,25,21,4,21,8,11,0,1,0,1,0
1229,132696,1001,Block 1001,29,33.7513175,-84.3510856,29,27,2,27,12,15,0,0,0,0,0
1230,132697,1002,Block 1002,24,33.7517162,-84.3522199,24,21,3,21,11,6,0,2,0,2,0
1231,132698,1003,Block 1003,18,33.751723,-84.3532481,18,15,3,15,7,6,0,0,1,0,1
1232,132699,1004,Block 1004,34,33.7517705,-84.3551599,34,30,4,30,14,14,0,0,0,0,2
1233,132700,1005,Block 1005,2,33.7509402,-84.3565532,2,2,0,2,1,1,0,0,0,0,0
1234,132701,1006,Block 1006,3,33.7497107,-84.3562112,3,3,0,3,3,0,0,0,0,0,0
1235,132702,1007,Block 1007,10,33.7496847,-84.3550471,10,8,2,8,5,3,0,0,0,0,0
1236,132703,1008,Block 1008,2,33.7503797,-84.3554849,2,2,0,2,1,0,0,1,0,0,0
1237,132704,1009,Block 1009,16,33.7506192,-84.3546582,16,16,0,16,9,6,0,1,0,0,0
1238,132705,1010,Block 1010,14,33.750594,-84.3532747,14,14,0,14,7,6,0,0,0,0,1
1239,132706,1011,Block 1011,11,33.7505919,-84.3522387,11,11,0,11,8,3,0,0,0,0,0
1240,132707,1012,Block 1012,61,33.7495658,-84.3527955,61,55,6,55,18,36,0,0,0,0,1
1241,132708,1013,Block 1013,2,33.7500441,-84.3545095,2,2,0,2,0,2,0,0,0,0,0
1242,132709,1014,Block 1014,7,33.7474322,-84.3506548,7,7,0,7,7,0,0,0,0,0,0
1243,132710,1015,Block 1015,47,33.74917,-84.3504023,47,34,13,34,14,20,0,0,0,0,0
1244,132713,1018,Block 1018,52,33.7477676,-84.3573788,52,52,0,52,29,16,0,4,0,0,3
1245,132714,1019,Block 1019,9,33.7488339,-84.3562111,9,8,1,8,6,2,0,0,0,0,0
1246,132715,1020,Block 1020,13,33.7488442,-84.3549915,13,10,3,10,6,3,0,1,0,0,0
1247,132716,1021,Block 1021,21,33.7478756,-84.3536457,21,18,3,18,10,8,0,0,0,0,0
1248,132717,1022,Block 1022,6,33.747777,-84.3520906,6,6,0,6,4,2,0,0,0,0,0
1249,132718,1023,Block 1023,1,33.7470331,-84.3562084,1,1,0,1,0,1,0,0,0,0,0
1250,132719,1024,Block 1024,15,33.747966,-84.3562134,15,15,0,15,7,7,0,1,0,0,0
1251,132720,1025,Block 1025,15,33.7479517,-84.3549941,15,15,0,15,9,5,0,0,0,0,1
1252,132721,1026,Block 1026,9,33.7470176,-84.3550018,9,7,2,7,5,2,0,0,0,0,0
1253,132728,2005,Block 2005,1,33.7584013,-84.3493281,1,1,0,1,1,0,0,0,0,0,0
1254,132729,2006,Block 2006,11,33.7580677,-84.3494691,11,10,1,10,5,4,0,0,0,1,0
1255,132730,2007,Block 2007,24,33.7573,-84.3500719,24,20,4,20,9,10,0,1,0,0,0
1256,132731,2008,Block 2008,2,33.7563869,-84.3506258,2,2,0,2,2,0,0,0,0,0,0
1257,132732,2009,Block 2009,155,33.7558765,-84.3523712,155,147,8,147,68,65,0,3,0,4,7
1258,132733,2010,Block 2010,21,33.7531093,-84.3521805,21,15,6,15,11,4,0,0,0,0,0
1259,132734,2011,Block 2011,15,33.7537746,-84.3503945,15,12,3,12,6,4,0,1,0,1,0
1260,132735,2012,Block 2012,23,33.7543026,-84.3504567,23,19,4,19,14,4,0,0,0,0,1
1261,132736,2013,Block 2013,31,33.7550262,-84.350671,31,25,6,25,15,9,0,0,0,0,1
1262,132737,2014,Block 2014,22,33.755825,-84.3501594,22,20,2,20,12,7,0,0,0,0,1
1263,132738,2015,Block 2015,15,33.7529654,-84.3531835,15,15,0,15,8,6,0,0,0,0,1
1264,132739,2016,Block 2016,24,33.7533252,-84.3553353,24,20,4,20,14,6,0,0,0,0,0
1265,132740,2017,Block 2017,12,33.7532379,-84.3503664,12,11,1,11,5,4,0,0,0,1,1
1266,132741,2018,Block 2018,38,33.752681,-84.3505061,38,33,5,33,3,30,0,0,0,0,0
1267,132749,1005,Block 1005,6,33.7514511,-84.3573149,6,6,0,6,3,3,0,0,0,0,0
1268,132750,1006,Block 1006,34,33.7513779,-84.3579528,34,27,7,27,16,11,0,0,0,0,0
1269,132751,1007,Block 1007,38,33.7513823,-84.3587273,38,36,2,36,23,12,0,1,0,0,0
1270,132752,1008,Block 1008,119,33.7521516,-84.360587,119,112,7,112,82,17,0,8,0,0,5
1271,132753,1009,Block 1009,47,33.7513246,-84.3627182,47,44,3,44,37,5,0,0,0,0,2
1272,132754,1010,Block 1010,21,33.7512064,-84.3637736,21,20,1,20,15,3,0,0,0,1,1
1273,132755,1011,Block 1011,1,33.7520575,-84.3648453,1,1,0,1,1,0,0,0,0,0,0
1274,132756,1012,Block 1012,17,33.750933,-84.3656402,17,17,0,17,16,0,0,0,0,0,1
1275,132757,1013,Block 1013,17,33.7511785,-84.3646554,17,17,0,17,13,1,0,3,0,0,0
1276,132758,1014,Block 1014,25,33.749236,-84.3639434,25,23,2,23,22,1,0,0,0,0,0
1277,132759,1015,Block 1015,32,33.7493972,-84.3627276,32,31,1,31,26,5,0,0,0,0,0
1278,132760,1016,Block 1016,40,33.7505109,-84.360657,40,34,6,34,19,14,0,0,0,0,1
1279,132761,1017,Block 1017,72,33.7512756,-84.3606495,72,68,4,68,40,18,2,0,0,0,8
1280,132762,1018,Block 1018,31,33.7498541,-84.3606787,31,29,2,29,25,3,1,0,0,0,0
1281,132763,1019,Block 1019,75,33.7496575,-84.3583455,75,65,10,65,45,15,1,0,0,0,4
1282,132764,1020,Block 1020,36,33.7492911,-84.3652115,36,35,1,35,33,1,0,1,0,0,0
1283,132765,1021,Block 1021,72,33.7494643,-84.3662641,72,61,11,61,56,4,0,0,0,1,0
1284,132766,1022,Block 1022,496,33.750617,-84.3688338,496,353,143,353,220,110,1,7,0,4,11
1285,132767,1023,Block 1023,39,33.7498728,-84.3677116,39,34,5,34,30,4,0,0,0,0,0
1286,132768,1024,Block 1024,38,33.7499664,-84.3670301,38,35,3,35,33,0,0,2,0,0,0
1287,132771,1027,Block 1027,32,33.7491955,-84.3608495,32,28,4,28,22,4,1,0,0,0,1
1288,132773,1029,Block 1029,30,33.7479461,-84.3585445,30,1,29,1,1,0,0,0,0,0,0
1289,132777,1033,Block 1033,13,33.7474143,-84.3626442,13,12,1,12,10,2,0,0,0,0,0
1290,132778,1034,Block 1034,2,33.7483502,-84.3624093,2,2,0,2,2,0,0,0,0,0,0
1291,132779,1035,Block 1035,23,33.747467,-84.3662059,23,21,2,21,19,0,0,1,0,1,0
1292,132780,1036,Block 1036,33,33.7474703,-84.3670664,33,31,2,31,29,1,0,0,0,1,0
1293,132781,1037,Block 1037,17,33.7485639,-84.3674089,17,16,1,16,15,1,0,0,0,0,0
1294,132782,1038,Block 1038,33,33.7487366,-84.368349,33,30,3,30,29,1,0,0,0,0,0
1295,132783,1039,Block 1039,12,33.7474954,-84.3677564,12,10,2,10,8,0,0,0,0,1,1
1296,132784,1040,Block 1040,8,33.7474543,-84.3651822,8,6,2,6,6,0,0,0,0,0,0
1297,132789,1001,Block 1001,239,33.7481766,-84.3780272,239,204,35,204,121,69,0,4,0,4,6
1298,132809,1021,Block 1021,84,33.7505242,-84.3908187,84,63,21,63,10,40,0,7,0,0,6
1299,132812,1024,Block 1024,72,33.749418,-84.3916865,72,57,15,57,19,33,0,1,0,3,1
1300,132822,1034,Block 1034,1,33.7483189,-84.3925551,1,0,1,0,0,0,0,0,0,0,0
1301,132842,2010,Block 2010,51,33.7528042,-84.3920429,51,38,13,38,16,20,1,0,0,0,1
1302,132845,2013,Block 2013,47,33.7525968,-84.3945471,47,38,9,38,18,15,1,3,0,0,1
1303,132851,2019,Block 2019,143,33.7505435,-84.3993243,143,123,20,123,86,29,0,4,0,1,3
1304,132852,2020,Block 2020,5,33.7510246,-84.3959105,5,1,4,1,1,0,0,0,0,0,0
1305,132857,2025,Block 2025,157,33.7524297,-84.3910113,157,150,7,150,40,97,0,4,0,1,8
1306,132858,2026,Block 2026,1,33.750067,-84.3928686,1,1,0,1,0,0,0,0,0,1,0
1307,132862,2030,Block 2030,4,33.750172,-84.3962805,4,1,3,1,0,1,0,0,0,0,0
1308,132870,2038,Block 2038,60,33.7491989,-84.4011945,60,52,8,52,32,16,0,3,0,1,0
1309,132871,2039,Block 2039,24,33.7486996,-84.4006606,24,21,3,21,14,5,0,0,0,0,2
1310,132872,2040,Block 2040,26,33.748499,-84.3997626,26,18,8,18,10,6,0,0,0,2,0
1311,132876,1000,Block 1000,1,33.7529851,-84.3984789,1,1,0,1,0,0,0,0,0,1,0
1312,132879,1003,Block 1003,141,33.7533624,-84.4021625,141,101,40,101,2,93,0,1,0,1,4
1313,132882,1006,Block 1006,129,33.7518366,-84.3988453,129,41,88,41,25,15,0,0,0,0,1
1314,132883,1007,Block 1007,56,33.751699,-84.4005113,56,45,11,45,9,36,0,0,0,0,0
1315,132884,1008,Block 1008,115,33.7525341,-84.4007709,115,87,28,87,17,62,0,4,0,2,2
1316,132886,1010,Block 1010,319,33.7514862,-84.4046262,319,288,31,288,3,277,0,0,0,6,2
1317,132889,1013,Block 1013,6,33.7529832,-84.4055173,6,6,0,6,0,6,0,0,0,0,0
1318,132890,1014,Block 1014,12,33.7501043,-84.4022323,12,12,0,12,0,10,0,0,0,2,0
1319,132892,1016,Block 1016,4,33.7507173,-84.400753,4,0,4,0,0,0,0,0,0,0,0
1320,132893,1017,Block 1017,139,33.7492174,-84.4030983,139,118,21,118,10,96,0,1,0,2,9
1321,132908,1001,Block 1001,41,33.7533662,-84.4097332,41,27,14,27,2,21,0,1,0,0,3
1322,132911,1004,Block 1004,7,33.7543879,-84.4159354,7,3,4,3,0,3,0,0,0,0,0
1323,132912,1005,Block 1005,10,33.7537596,-84.4159979,10,6,4,6,0,6,0,0,0,0,0
1324,132913,1006,Block 1006,39,33.7531359,-84.4159515,39,22,17,22,0,22,0,0,0,0,0
1325,132918,1011,Block 1011,48,33.7525003,-84.4159576,48,32,16,32,0,31,0,1,0,0,0
1326,132919,1012,Block 1012,21,33.7514875,-84.4170502,21,19,2,19,0,18,0,0,0,1,0
1327,132920,1013,Block 1013,23,33.7514986,-84.4160721,23,15,8,15,0,15,0,0,0,0,0
1328,132921,1014,Block 1014,3,33.751508,-84.4150848,3,2,1,2,0,2,0,0,0,0,0
1329,132922,1015,Block 1015,22,33.7515345,-84.4123878,22,5,17,5,0,3,0,1,0,0,1
1330,132924,1017,Block 1017,20,33.7516802,-84.4096269,20,6,14,6,0,6,0,0,0,0,0
1331,132925,1018,Block 1018,17,33.7516668,-84.4072338,17,7,10,7,0,6,0,0,0,0,1
1332,132926,1019,Block 1019,13,33.7502555,-84.407223,13,9,4,9,0,8,0,0,0,0,1
1333,132930,1023,Block 1023,21,33.7499912,-84.4168163,21,17,4,17,1,14,0,0,0,2,0
1334,132931,1024,Block 1024,21,33.7500268,-84.4156963,21,5,16,5,0,5,0,0,0,0,0
1335,132932,1025,Block 1025,21,33.7500652,-84.414867,21,12,9,12,0,11,1,0,0,0,0
1336,132933,1026,Block 1026,24,33.7500934,-84.4140338,24,13,11,13,0,11,0,0,0,0,2
1337,132934,1027,Block 1027,2,33.7501232,-84.4132109,2,2,0,2,0,2,0,0,0,0,0
1338,132935,1028,Block 1028,1,33.750142,-84.4123875,1,0,1,0,0,0,0,0,0,0,0
1339,132936,1029,Block 1029,6,33.7501383,-84.4116477,6,6,0,6,0,6,0,0,0,0,0
1340,132937,1030,Block 1030,1,33.7482202,-84.4119252,1,0,1,0,0,0,0,0,0,0,0
1341,132942,1000,Block 1000,5,33.7541545,-84.4181258,5,2,3,2,0,2,0,0,0,0,0
1342,132943,1001,Block 1001,11,33.7541674,-84.4192806,11,8,3,8,0,8,0,0,0,0,0
1343,132944,1002,Block 1002,20,33.7534418,-84.4221364,20,16,4,16,2,13,1,0,0,0,0
1344,132945,1003,Block 1003,18,33.752149,-84.4214581,18,14,4,14,0,13,0,0,0,0,1
1345,132946,1004,Block 1004,84,33.7502406,-84.4266383,84,60,24,60,1,57,1,0,0,0,1
1346,132948,1006,Block 1006,37,33.749827,-84.4259009,37,23,14,23,1,22,0,0,0,0,0
1347,132949,1007,Block 1007,39,33.7502806,-84.4248505,39,33,6,33,1,28,3,0,0,0,1
1348,132951,1009,Block 1009,13,33.7521685,-84.4247856,13,10,3,10,0,10,0,0,0,0,0
1349,132953,1011,Block 1011,16,33.7514558,-84.4231759,16,14,2,14,1,12,0,0,0,0,1
1350,132954,1012,Block 1012,18,33.7514484,-84.4214697,18,13,5,13,0,13,0,0,0,0,0
1351,132955,1013,Block 1013,18,33.7514548,-84.4198537,18,14,4,14,0,14,0,0,0,0,0
1352,132956,1014,Block 1014,18,33.7521413,-84.4198563,18,10,8,10,0,10,0,0,0,0,0
1353,132957,1015,Block 1015,17,33.7530368,-84.4192803,17,8,9,8,1,6,0,0,0,0,1
1354,132958,1016,Block 1016,18,33.7530263,-84.418115,18,13,5,13,0,13,0,0,0,0,0
1355,132959,1017,Block 1017,16,33.7521298,-84.4183401,16,10,6,10,0,10,0,0,0,0,0
1356,132960,1018,Block 1018,13,33.7514435,-84.4183403,13,10,3,10,1,8,0,0,0,0,1
1357,132961,1019,Block 1019,17,33.7507565,-84.4183364,17,9,8,9,2,7,0,0,0,0,0
1358,132962,1020,Block 1020,16,33.7507673,-84.419854,16,9,7,9,0,9,0,0,0,0,0
1359,132963,1021,Block 1021,22,33.7507576,-84.4214406,22,12,10,12,0,12,0,0,0,0,0
1360,132964,1022,Block 1022,30,33.7481189,-84.4259649,30,21,9,21,0,19,1,0,0,0,1
1361,132966,2000,Block 2000,26,33.7501674,-84.4194993,26,13,13,13,0,13,0,0,0,0,0
1362,132967,2001,Block 2001,26,33.750161,-84.4223297,26,12,14,12,0,12,0,0,0,0,0
1363,132968,2002,Block 2002,8,33.7507306,-84.4227975,8,3,5,3,0,3,0,0,0,0,0
1364,132969,2003,Block 2003,37,33.7500581,-84.4237929,37,23,14,23,0,23,0,0,0,0,0
1365,132970,2004,Block 2004,66,33.7480711,-84.4238056,66,33,33,33,0,31,0,0,0,0,2
1366,132971,2005,Block 2005,30,33.748118,-84.4248634,30,23,7,23,0,23,0,0,0,0,0
1367,132972,2006,Block 2006,3,33.748156,-84.4223095,3,3,0,3,0,2,0,0,0,0,1
1368,132973,2007,Block 2007,52,33.7494878,-84.4194846,52,22,30,22,0,21,0,0,0,1,0
1369,132974,2008,Block 2008,40,33.7494828,-84.4223482,40,25,15,25,1,24,0,0,0,0,0
1370,132976,2010,Block 2010,105,33.7477168,-84.4196445,105,71,34,71,0,70,0,0,0,0,1
1371,132977,2011,Block 2011,21,33.7487279,-84.4185988,21,12,9,12,0,12,0,0,0,0,0
1372,132978,2012,Block 2012,3,33.7478718,-84.4184814,3,2,1,2,0,1,0,0,0,1,0
1373,132982,1000,Block 1000,7,33.7528494,-84.4263887,7,6,1,6,0,6,0,0,0,0,0
1374,132983,1001,Block 1001,19,33.7529223,-84.4274078,19,18,1,18,2,16,0,0,0,0,0
1375,132984,1002,Block 1002,45,33.7509264,-84.4299133,45,34,11,34,1,31,0,0,0,0,2
1376,132985,1003,Block 1003,25,33.7518544,-84.4309686,25,16,9,16,0,16,0,0,0,0,0
1377,132986,1004,Block 1004,25,33.7525157,-84.4309503,25,16,9,16,0,16,0,0,0,0,0
1378,132987,1005,Block 1005,13,33.7530695,-84.4291937,13,7,6,7,1,6,0,0,0,0,0
1379,132988,1006,Block 1006,23,33.7532522,-84.4309368,23,17,6,17,0,17,0,0,0,0,0
1380,132989,1007,Block 1007,34,33.7524627,-84.4327154,34,29,5,29,1,28,0,0,0,0,0
1381,132990,1008,Block 1008,32,33.7529819,-84.4346589,32,25,7,25,0,22,1,0,0,0,2
1382,132991,1009,Block 1009,39,33.7540368,-84.4382967,39,33,6,33,1,32,0,0,0,0,0
1383,132993,1011,Block 1011,3,33.7523461,-84.4450894,3,2,1,2,0,2,0,0,0,0,0
1384,132994,1012,Block 1012,34,33.7517237,-84.43474,34,29,5,29,0,28,0,0,0,0,1
1385,132995,1013,Block 1013,29,33.7521263,-84.4371176,29,22,7,22,0,22,0,0,0,0,0
1386,132996,1014,Block 1014,22,33.7522179,-84.4390471,22,17,5,17,0,17,0,0,0,0,0
1387,133000,1018,Block 1018,41,33.7496183,-84.4284602,41,38,3,38,1,37,0,0,0,0,0
1388,133001,1019,Block 1019,20,33.7489795,-84.430081,20,18,2,18,0,16,0,1,0,1,0
1389,133002,1020,Block 1020,37,33.7515273,-84.4281551,37,27,10,27,1,26,0,0,0,0,0
1390,133003,1021,Block 1021,23,33.7518544,-84.4434501,23,17,6,17,1,12,0,0,0,0,4
1391,133004,1022,Block 1022,13,33.752012,-84.4417308,13,10,3,10,0,10,0,0,0,0,0
1392,133005,1023,Block 1023,5,33.752733,-84.4418544,5,4,1,4,0,4,0,0,0,0,0
1393,133006,1024,Block 1024,24,33.7484511,-84.4315835,24,17,7,17,0,17,0,0,0,0,0
1394,133007,1025,Block 1025,16,33.7503366,-84.4317353,16,13,3,13,0,13,0,0,0,0,0
1395,133010,2001,Block 2001,44,33.7491443,-84.4406846,44,35,9,35,0,35,0,0,0,0,0
1396,133012,2003,Block 2003,9,33.7497447,-84.4417848,9,4,5,4,0,4,0,0,0,0,0
1397,133013,2004,Block 2004,18,33.7508501,-84.4421735,18,12,6,12,0,12,0,0,0,0,0
1398,133016,2007,Block 2007,1,33.7504806,-84.4448908,1,0,1,0,0,0,0,0,0,0,0
1399,133021,2012,Block 2012,156,33.7455615,-84.4360946,156,95,61,95,6,85,1,0,0,0,3
1400,133022,2013,Block 2013,20,33.7447461,-84.4356768,20,16,4,16,2,14,0,0,0,0,0
1401,133023,2014,Block 2014,29,33.7449409,-84.4345247,29,21,8,21,1,20,0,0,0,0,0
1402,133024,2015,Block 2015,20,33.7447591,-84.436826,20,18,2,18,2,15,0,0,0,0,1
1403,133025,2016,Block 2016,10,33.7434141,-84.436824,10,8,2,8,0,8,0,0,0,0,0
1404,133026,2017,Block 2017,17,33.743316,-84.4356768,17,14,3,14,1,13,0,0,0,0,0
1405,133027,2018,Block 2018,5,33.7469522,-84.4408072,5,5,0,5,0,5,0,0,0,0,0
1406,133028,2019,Block 2019,3,33.7486923,-84.4425254,3,1,2,1,0,1,0,0,0,0,0
1407,133030,3000,Block 3000,26,33.7503858,-84.4334288,26,23,3,23,0,23,0,0,0,0,0
1408,133031,3001,Block 3001,22,33.7504027,-84.435412,22,18,4,18,1,16,0,0,0,1,0
1409,133032,3002,Block 3002,32,33.7504286,-84.4372044,32,22,10,22,0,22,0,0,0,0,0
1410,133033,3003,Block 3003,21,33.7513001,-84.4392204,21,15,6,15,0,15,0,0,0,0,0
1411,133034,3004,Block 3004,14,33.7512404,-84.440702,14,13,1,13,0,12,0,0,0,1,0
1412,133035,3005,Block 3005,27,33.7502579,-84.4392404,27,22,5,22,0,20,0,0,0,0,2
1413,133036,3006,Block 3006,24,33.7492214,-84.4392639,24,14,10,14,0,14,0,0,0,0,0
1414,133037,3007,Block 3007,49,33.7485575,-84.4373098,49,28,21,28,0,28,0,0,0,0,0
1415,133038,3008,Block 3008,27,33.7485327,-84.4358334,27,25,2,25,0,25,0,0,0,0,0
1416,133039,3009,Block 3009,16,33.748514,-84.435011,16,12,4,12,0,12,0,0,0,0,0
1417,133040,3010,Block 3010,25,33.7487126,-84.4332299,25,21,4,21,0,21,0,0,0,0,0
1418,133041,3011,Block 3011,14,33.7478506,-84.4340445,14,13,1,13,0,13,0,0,0,0,0
1419,133044,1000,Block 1000,18,33.7461809,-84.4237562,18,9,9,9,0,9,0,0,0,0,0
1420,133045,1001,Block 1001,47,33.7462479,-84.4256207,47,30,17,30,1,27,1,0,1,0,0
1421,133046,1002,Block 1002,53,33.746297,-84.4283025,53,31,22,31,1,28,1,0,0,0,1
1422,133048,1004,Block 1004,19,33.7445658,-84.4238471,19,10,9,10,0,10,0,0,0,0,0
1423,133052,1008,Block 1008,29,33.7438166,-84.4262392,29,14,15,14,1,13,0,0,0,0,0
1424,133053,1009,Block 1009,16,33.7456562,-84.4298355,16,14,2,14,1,13,0,0,0,0,0
1425,133054,1010,Block 1010,38,33.7445712,-84.429703,38,23,15,23,1,22,0,0,0,0,0
1426,133055,1011,Block 1011,15,33.7445632,-84.4314211,15,13,2,13,0,13,0,0,0,0,0
1427,133057,2000,Block 2000,12,33.743836,-84.4327082,12,9,3,9,0,9,0,0,0,0,0
1428,133058,2001,Block 2001,41,33.7430965,-84.4314896,41,27,14,27,0,26,0,0,0,1,0
1429,133059,2002,Block 2002,94,33.7430499,-84.4260614,94,47,47,47,2,39,0,5,0,0,1
1430,133060,2003,Block 2003,40,33.7430768,-84.4279618,40,22,18,22,0,21,0,0,0,0,1
1431,133061,2004,Block 2004,28,33.7431013,-84.4297163,28,25,3,25,0,25,0,0,0,0,0
1432,133062,2005,Block 2005,45,33.7413947,-84.4297388,45,36,9,36,3,32,0,0,0,0,1
1433,133063,2006,Block 2006,19,33.7418421,-84.4314844,19,10,9,10,0,7,0,0,0,0,3
1434,133064,2007,Block 2007,21,33.7409529,-84.4315132,21,14,7,14,0,14,0,0,0,0,0
1435,133065,2008,Block 2008,77,33.7415539,-84.4262383,77,49,28,49,0,48,0,0,0,0,1
1436,133067,2010,Block 2010,40,33.7413875,-84.4280168,40,27,13,27,3,23,0,0,0,0,1
1437,133069,3000,Block 3000,31,33.7395939,-84.4240746,31,20,11,20,1,18,0,0,0,0,1
1438,133070,3001,Block 3001,29,33.7402949,-84.4259882,29,20,9,20,2,18,0,0,0,0,0
1439,133071,3002,Block 3002,15,33.7395736,-84.428072,15,11,4,11,0,11,0,0,0,0,0
1440,133072,3003,Block 3003,14,33.7396778,-84.4297964,14,10,4,10,0,10,0,0,0,0,0
1441,133073,3004,Block 3004,17,33.7397439,-84.4315385,17,14,3,14,0,13,0,0,0,0,1
1442,133074,3005,Block 3005,21,33.7398922,-84.4329352,21,15,6,15,1,12,0,0,0,0,2
1443,133075,3006,Block 3006,13,33.7414091,-84.4330147,13,8,5,8,0,8,0,0,0,0,0
1444,133077,3008,Block 3008,13,33.7415535,-84.4349564,13,9,4,9,0,8,0,0,0,0,1
1445,133078,3009,Block 3009,94,33.7378478,-84.428911,94,72,22,72,6,59,0,0,0,4,3
1446,133079,3010,Block 3010,32,33.7372336,-84.4271578,32,26,6,26,3,23,0,0,0,0,0
1447,133080,3011,Block 3011,31,33.7362689,-84.4244321,31,26,5,26,2,24,0,0,0,0,0
1448,133081,3012,Block 3012,33,33.7371497,-84.4260273,33,25,8,25,4,18,0,0,0,0,3
1449,133084,3015,Block 3015,17,33.7391561,-84.4260188,17,13,4,13,1,11,0,0,0,0,1
1450,133085,3016,Block 3016,38,33.7376012,-84.4244293,38,32,6,32,3,27,0,1,0,1,0
1451,133087,3018,Block 3018,16,33.7341985,-84.4240714,16,12,4,12,0,11,0,0,0,0,1
1452,133090,1000,Block 1000,20,33.7437215,-84.4158133,20,16,4,16,1,15,0,0,0,0,0
1453,133091,1001,Block 1001,301,33.7443216,-84.4190198,301,262,39,262,2,253,1,0,0,0,6
1454,133094,1004,Block 1004,27,33.7424303,-84.4158136,27,26,1,26,3,23,0,0,0,0,0
1455,133103,2004,Block 2004,3,33.7411402,-84.4183834,3,3,0,3,0,2,0,1,0,0,0
1456,133105,2006,Block 2006,6,33.7420707,-84.419351,6,0,6,0,0,0,0,0,0,0,0
1457,133106,2007,Block 2007,195,33.7427384,-84.4184001,195,192,3,192,3,189,0,0,0,0,0
1458,133112,2013,Block 2013,151,33.7393489,-84.4170795,151,74,77,74,1,71,0,2,0,0,0
1459,133113,2014,Block 2014,15,33.739718,-84.419096,15,11,4,11,0,11,0,0,0,0,0
1460,133114,2015,Block 2015,30,33.7397271,-84.4198426,30,28,2,28,0,28,0,0,0,0,0
1461,133115,2016,Block 2016,16,33.7412484,-84.4214613,16,9,7,9,2,7,0,0,0,0,0
1462,133118,2019,Block 2019,18,33.7414974,-84.4228113,18,12,6,12,5,6,0,0,0,0,1
1463,133119,2020,Block 2020,2,33.7422242,-84.4225109,2,1,1,1,1,0,0,0,0,0,0
1464,133120,2021,Block 2021,144,33.7364463,-84.4159043,144,138,6,138,3,133,0,1,0,0,1
1465,133126,2027,Block 2027,112,33.7346315,-84.4147449,112,96,16,96,2,91,1,0,0,0,2
1466,133127,2028,Block 2028,25,33.7350663,-84.4160281,25,23,2,23,0,22,0,0,0,0,1
1467,133128,2029,Block 2029,42,33.7346704,-84.4169557,42,35,7,35,0,33,1,0,0,0,1
1468,133129,2030,Block 2030,24,33.7352281,-84.4184086,24,18,6,18,2,16,0,0,0,0,0
1469,133130,2031,Block 2031,18,33.7368977,-84.4185183,18,16,2,16,1,15,0,0,0,0,0
1470,133131,2032,Block 2032,25,33.7368883,-84.4199046,25,24,1,24,3,21,0,0,0,0,0
1471,133132,2033,Block 2033,156,33.7369938,-84.4219685,156,147,9,147,5,136,2,0,0,0,4
1472,133133,2034,Block 2034,36,33.7395212,-84.4228289,36,30,6,30,3,26,0,0,0,0,1
1473,133135,2036,Block 2036,17,33.7352171,-84.4197858,17,16,1,16,3,13,0,0,0,0,0
1474,133136,2037,Block 2037,49,33.7345933,-84.4219268,49,39,10,39,3,36,0,0,0,0,0
1475,133137,2038,Block 2038,19,33.7340072,-84.4197818,19,10,9,10,4,5,0,0,0,0,1
1476,133138,2039,Block 2039,23,33.7340253,-84.4184038,23,17,6,17,0,17,0,0,0,0,0
1477,133139,2040,Block 2040,15,33.7336406,-84.4165507,15,12,3,12,1,10,0,0,0,0,1
1478,133145,1000,Block 1000,1,33.7453055,-84.4110223,1,1,0,1,0,1,0,0,0,0,0
1479,133148,1003,Block 1003,4,33.7454924,-84.4149216,4,2,2,2,0,2,0,0,0,0,0
1480,133152,1007,Block 1007,1,33.7442106,-84.4129966,1,1,0,1,0,0,0,0,0,0,1
1481,133156,2000,Block 2000,71,33.7476593,-84.4022947,71,67,4,67,25,36,2,2,0,0,2
1482,133158,2002,Block 2002,9,33.7464057,-84.4031832,9,8,1,8,7,1,0,0,0,0,0
1483,133159,2003,Block 2003,70,33.7461682,-84.4022527,70,57,13,57,45,12,0,0,0,0,0
1484,133160,2004,Block 2004,16,33.7454829,-84.4034701,16,15,1,15,13,0,0,1,0,1,0
1485,133161,2005,Block 2005,1,33.7461498,-84.4049956,1,1,0,1,1,0,0,0,0,0,0
1486,133164,2008,Block 2008,26,33.7477093,-84.4040615,26,14,12,14,1,12,0,1,0,0,0
1487,133165,2009,Block 2009,3,33.7473904,-84.4035152,3,3,0,3,3,0,0,0,0,0,0
1488,133166,2010,Block 2010,3,33.746365,-84.4040408,3,3,0,3,3,0,0,0,0,0,0
1489,133168,2012,Block 2012,183,33.744752,-84.4066022,183,165,18,165,1,159,0,0,0,2,3
1490,133169,2013,Block 2013,250,33.745843,-84.4081194,250,220,30,220,0,216,0,1,0,0,3
1491,133174,1002,Block 1002,12,33.7455569,-84.4010509,12,9,3,9,7,2,0,0,0,0,0
1492,133176,1004,Block 1004,30,33.743482,-84.405348,30,17,13,17,6,11,0,0,0,0,0
1493,133186,1014,Block 1014,42,33.7432005,-84.4000477,42,31,11,31,0,31,0,0,0,0,0
1494,133187,1015,Block 1015,71,33.7425479,-84.3999856,71,51,20,51,0,50,0,0,0,0,1
1495,133189,1017,Block 1017,63,33.7402374,-84.4019666,63,53,10,53,0,51,0,0,0,1,1
1496,133192,1020,Block 1020,14,33.7388619,-84.4006098,14,10,4,10,0,10,0,0,0,0,0
1497,133193,1021,Block 1021,12,33.737561,-84.4003989,12,10,2,10,0,10,0,0,0,0,0
1498,133194,1022,Block 1022,8,33.737545,-84.3995507,8,5,3,5,0,5,0,0,0,0,0
1499,133195,1023,Block 1023,4,33.7375378,-84.3987303,4,3,1,3,0,3,0,0,0,0,0
1500,133196,1024,Block 1024,17,33.7362894,-84.3987318,17,15,2,15,1,13,0,0,0,0,1
1501,133197,1025,Block 1025,18,33.736302,-84.3995475,18,12,6,12,2,10,0,0,0,0,0
1502,133198,1026,Block 1026,28,33.7363178,-84.4004046,28,22,6,22,1,20,0,0,0,1,0
1503,133199,1027,Block 1027,8,33.7363307,-84.4012479,8,8,0,8,0,8,0,0,0,0,0
1504,133201,1029,Block 1029,201,33.7375635,-84.4030501,201,167,34,167,0,167,0,0,0,0,0
1505,133202,1030,Block 1030,319,33.7396255,-84.4034704,319,302,17,302,0,293,1,0,0,0,8
1506,133203,1031,Block 1031,72,33.7416107,-84.4038054,72,71,1,71,0,68,0,0,0,0,3
1507,133205,1033,Block 1033,164,33.7408185,-84.405808,164,142,22,142,1,141,0,0,0,0,0
1508,133208,1036,Block 1036,20,33.735004,-84.3987424,20,18,2,18,0,18,0,0,0,0,0
1509,133209,1037,Block 1037,17,33.7350098,-84.3995554,17,13,4,13,0,13,0,0,0,0,0
1510,133210,1038,Block 1038,6,33.7350477,-84.4004021,6,5,1,5,0,5,0,0,0,0,0
1511,133211,1039,Block 1039,7,33.7351265,-84.4012324,7,5,2,5,0,5,0,0,0,0,0
1512,133212,1040,Block 1040,1,33.73632,-84.4023621,1,1,0,1,1,0,0,0,0,0,0
1513,133215,1000,Block 1000,207,33.744312,-84.3818405,207,204,3,204,10,189,2,0,0,1,2
1514,133216,1001,Block 1001,66,33.7451251,-84.3821044,66,59,7,59,4,52,0,0,0,0,3
1515,133218,1003,Block 1003,70,33.7451471,-84.3832575,70,62,8,62,2,59,0,0,0,0,1
1516,133219,1004,Block 1004,105,33.746265,-84.3820961,105,96,9,96,5,85,1,0,0,0,5
1517,133221,1006,Block 1006,3,33.7462809,-84.3850325,3,3,0,3,2,1,0,0,0,0,0
1518,133225,1010,Block 1010,2,33.7436952,-84.3799115,2,1,1,1,0,1,0,0,0,0,0
1519,133231,1016,Block 1016,10,33.7427388,-84.3843865,10,8,2,8,1,6,0,1,0,0,0
1520,133233,1018,Block 1018,1,33.7422644,-84.3832269,1,1,0,1,0,1,0,0,0,0,0
1521,133238,1023,Block 1023,152,33.7450168,-84.385472,152,134,18,134,8,123,0,1,0,1,1
1522,133239,1024,Block 1024,4,33.7420785,-84.3821483,4,4,0,4,2,1,0,0,0,0,1
1523,133240,1025,Block 1025,7,33.7417437,-84.3829321,7,7,0,7,1,5,0,0,0,0,1
1524,133243,1000,Block 1000,31,33.741196,-84.3828026,31,27,4,27,5,21,0,1,0,0,0
1525,133244,1001,Block 1001,40,33.7416541,-84.3851457,40,35,5,35,5,30,0,0,0,0,0
1526,133245,1002,Block 1002,22,33.7409798,-84.3847401,22,19,3,19,7,11,0,0,0,0,1
1527,133246,1003,Block 1003,26,33.740636,-84.3858652,26,24,2,24,6,18,0,0,0,0,0
1528,133249,1006,Block 1006,19,33.7396815,-84.3847904,19,18,1,18,1,16,0,1,0,0,0
1529,133250,1007,Block 1007,24,33.7402835,-84.384761,24,21,3,21,10,11,0,0,0,0,0
1530,133251,1008,Block 1008,42,33.7403952,-84.3828144,42,32,10,32,10,22,0,0,0,0,0
1531,133252,1009,Block 1009,33,33.7396995,-84.3827777,33,29,4,29,7,20,0,1,1,0,0
1532,133253,1010,Block 1010,163,33.7380648,-84.3827894,163,159,4,159,6,147,0,0,0,2,4
1533,133254,1011,Block 1011,4,33.73911,-84.3830991,4,4,0,4,1,3,0,0,0,0,0
1534,133255,1012,Block 1012,28,33.7386729,-84.384456,28,25,3,25,5,18,1,1,0,0,0
1535,133256,1013,Block 1013,32,33.7386789,-84.3851874,32,31,1,31,6,24,0,1,0,0,0
1536,133257,1014,Block 1014,4,33.7386864,-84.3859242,4,3,1,3,0,3,0,0,0,0,0
1537,133258,1015,Block 1015,31,33.7373698,-84.3859415,31,27,4,27,3,24,0,0,0,0,0
1538,133259,1016,Block 1016,9,33.737354,-84.3848271,9,9,0,9,1,8,0,0,0,0,0
1539,133263,2000,Block 2000,18,33.7461744,-84.3741336,18,17,1,17,11,5,0,1,0,0,0
1540,133264,2001,Block 2001,27,33.7461891,-84.3756637,27,26,1,26,20,5,0,0,0,0,1
1541,133265,2002,Block 2002,15,33.746207,-84.3767387,15,13,2,13,11,2,0,0,0,0,0
1542,133266,2003,Block 2003,6,33.7462211,-84.3781636,6,5,1,5,4,1,0,0,0,0,0
1543,133267,2004,Block 2004,10,33.7462334,-84.3798773,10,7,3,7,4,2,0,0,0,1,0
1544,133268,2005,Block 2005,12,33.7447855,-84.3798906,12,10,2,10,3,7,0,0,0,0,0
1545,133269,2006,Block 2006,27,33.7450338,-84.3778956,27,26,1,26,21,3,0,2,0,0,0
1546,133270,2007,Block 2007,102,33.7444258,-84.3753411,102,85,17,85,65,11,0,4,0,0,5
1547,133271,2008,Block 2008,1,33.7441432,-84.378585,1,1,0,1,0,0,0,0,0,1,0
1548,133274,2011,Block 2011,54,33.7428144,-84.3762985,54,48,6,48,42,4,0,0,0,0,2
1549,133275,2012,Block 2012,19,33.7417911,-84.3771196,19,19,0,19,16,0,0,1,0,1,1
1550,133276,2013,Block 2013,15,33.7418163,-84.3784798,15,13,2,13,11,2,0,0,0,0,0
1551,133277,2014,Block 2014,26,33.7418076,-84.3797971,26,25,1,25,11,11,0,0,0,0,3
1552,133278,2015,Block 2015,16,33.7419311,-84.3809907,16,13,3,13,8,4,0,1,0,0,0
1553,133279,2016,Block 2016,27,33.7395649,-84.3802091,27,22,5,22,17,5,0,0,0,0,0
1554,133280,2017,Block 2017,16,33.7406257,-84.3783149,16,13,3,13,13,0,0,0,0,0,0
1555,133281,2018,Block 2018,4,33.741002,-84.3769882,4,4,0,4,4,0,0,0,0,0,0
1556,133282,2019,Block 2019,20,33.7406,-84.3755702,20,18,2,18,17,1,0,0,0,0,0
1557,133283,2020,Block 2020,21,33.7417932,-84.375641,21,18,3,18,14,3,0,0,0,0,1
1558,133284,2021,Block 2021,20,33.7417814,-84.374189,20,17,3,17,15,1,1,0,0,0,0
1559,133285,2022,Block 2022,20,33.7405917,-84.3742364,20,17,3,17,15,1,1,0,0,0,0
1560,133286,2023,Block 2023,21,33.7394333,-84.3742365,21,20,1,20,19,1,0,0,0,0,0
1561,133287,2024,Block 2024,21,33.7394546,-84.3755736,21,19,2,19,17,2,0,0,0,0,0
1562,133288,2025,Block 2025,20,33.7394727,-84.3770087,20,20,0,20,18,2,0,0,0,0,0
1563,133289,2026,Block 2026,16,33.7404137,-84.3769952,16,14,2,14,13,1,0,0,0,0,0
1564,133290,2027,Block 2027,7,33.7384589,-84.3782261,7,7,0,7,7,0,0,0,0,0,0
1565,133291,2028,Block 2028,14,33.7394952,-84.3783239,14,14,0,14,14,0,0,0,0,0,0
1566,133292,2029,Block 2029,14,33.7383812,-84.3770542,14,14,0,14,14,0,0,0,0,0,0
1567,133293,2030,Block 2030,16,33.7383409,-84.3756123,16,14,2,14,14,0,0,0,0,0,0
1568,133294,2031,Block 2031,13,33.7383142,-84.3742429,13,13,0,13,12,1,0,0,0,0,0
1569,133295,2032,Block 2032,39,33.7372039,-84.3750537,39,38,1,38,31,6,0,0,0,0,1
1570,133296,2033,Block 2033,13,33.7372475,-84.3769521,13,13,0,13,11,2,0,0,0,0,0
1571,133297,2034,Block 2034,14,33.7372777,-84.3779348,14,14,0,14,11,2,0,1,0,0,0
1572,133301,1000,Block 1000,60,33.7457272,-84.3582407,60,47,13,47,33,14,0,0,0,0,0
1573,133302,1001,Block 1001,18,33.7451365,-84.362487,18,15,3,15,10,2,0,0,0,0,3
1574,133303,1002,Block 1002,20,33.744554,-84.365984,20,19,1,19,15,3,0,1,0,0,0
1575,133305,1004,Block 1004,34,33.7448477,-84.3645137,34,27,7,27,12,12,2,0,0,1,0
1576,133306,1005,Block 1005,18,33.7457334,-84.3644989,18,17,1,17,14,2,0,1,0,0,0
1577,133307,1006,Block 1006,2,33.7463478,-84.3644909,2,1,1,1,0,1,0,0,0,0,0
1578,133308,1007,Block 1007,6,33.7463647,-84.3659662,6,6,0,6,4,0,0,0,0,2,0
1579,133309,1008,Block 1008,7,33.7463769,-84.3674072,7,6,1,6,3,0,0,1,0,1,1
1580,133310,1009,Block 1009,74,33.7461038,-84.3689024,74,56,18,56,39,11,0,3,0,1,2
1581,133311,1010,Block 1010,1,33.7461254,-84.3705447,1,1,0,1,0,1,0,0,0,0,0
1582,133314,1013,Block 1013,43,33.7448994,-84.3723522,43,41,2,41,32,6,0,1,0,1,1
1583,133315,1014,Block 1014,27,33.7448751,-84.370517,27,25,2,25,21,4,0,0,0,0,0
1584,133316,1015,Block 1015,15,33.744648,-84.3689397,15,14,1,14,14,0,0,0,0,0,0
1585,133318,1017,Block 1017,19,33.7457632,-84.3674084,19,18,1,18,14,1,0,0,0,3,0
1586,133319,1018,Block 1018,20,33.7457482,-84.3659659,20,16,4,16,13,3,0,0,0,0,0
1587,133320,1019,Block 1019,16,33.7451516,-84.3659755,16,13,3,13,11,1,0,0,0,0,1
1588,133324,1023,Block 1023,22,33.7438908,-84.3716283,22,19,3,19,14,4,0,1,0,0,0
1589,133331,1030,Block 1030,40,33.7418583,-84.3618421,40,39,1,39,26,12,0,0,0,0,1
1590,133332,1031,Block 1031,28,33.7408767,-84.3644917,28,23,5,23,16,6,0,0,0,0,1
1591,133333,1032,Block 1032,46,33.7412503,-84.3659541,46,42,4,42,36,6,0,0,0,0,0
1592,133336,1035,Block 1035,33,33.7423457,-84.3724838,33,33,0,33,24,7,0,0,0,0,2
1593,133337,1036,Block 1036,32,33.7422305,-84.3706848,32,29,3,29,20,3,0,0,0,0,6
1594,133338,1037,Block 1037,13,33.7418493,-84.3689856,13,13,0,13,8,4,0,1,0,0,0
1595,133339,1038,Block 1038,20,33.741338,-84.3674033,20,19,1,19,15,2,0,0,0,0,2
1596,133340,1039,Block 1039,20,33.7395193,-84.3674198,20,19,1,19,15,4,0,0,0,0,0
1597,133341,1040,Block 1040,31,33.7404282,-84.368973,31,28,3,28,19,9,0,0,0,0,0
1598,133342,1041,Block 1041,28,33.7391908,-84.3689879,28,25,3,25,19,4,1,0,0,0,1
1599,133343,1042,Block 1042,187,33.7384932,-84.362012,187,154,33,154,104,44,1,3,0,2,0
1600,133344,1043,Block 1043,22,33.7395107,-84.3659358,22,22,0,22,22,0,0,0,0,0,0
1601,133345,1044,Block 1044,26,33.7382727,-84.3659434,26,25,1,25,23,1,0,0,0,1,0
1602,133346,1045,Block 1045,21,33.7382794,-84.3674307,21,20,1,20,14,5,0,0,0,0,1
1603,133347,1046,Block 1046,43,33.7378634,-84.3690135,43,29,14,29,24,3,0,1,0,0,1
1604,133348,1047,Block 1047,13,33.7372386,-84.367439,13,12,1,12,9,2,1,0,0,0,0
1605,133349,1048,Block 1048,17,33.7372219,-84.3659456,17,17,0,17,13,2,0,0,0,0,2
1606,133352,1000,Block 1000,9,33.7355219,-84.3501466,9,8,1,8,7,1,0,0,0,0,0
1607,133353,1001,Block 1001,83,33.7351077,-84.3540444,83,79,4,79,73,1,0,3,0,0,2
1608,133354,1002,Block 1002,23,33.7359967,-84.3567495,23,22,1,22,20,2,0,0,0,0,0
1609,133355,1003,Block 1003,43,33.7349338,-84.3587809,43,41,2,41,31,9,0,0,0,1,0
1610,133356,1004,Block 1004,27,33.7335782,-84.3573236,27,25,2,25,19,4,1,0,0,1,0
1611,133357,1005,Block 1005,39,33.7333931,-84.3536556,39,37,2,37,24,12,1,0,0,0,0
1612,133358,1006,Block 1006,23,33.7331703,-84.3505093,23,20,3,20,18,0,0,0,0,2,0
1613,133359,1007,Block 1007,10,33.7323584,-84.3499638,10,10,0,10,8,2,0,0,0,0,0
1614,133360,1008,Block 1008,12,33.7345409,-84.3502371,12,11,1,11,11,0,0,0,0,0,0
1615,133361,1009,Block 1009,11,33.7320744,-84.3548704,11,11,0,11,11,0,0,0,0,0,0
1616,133362,1010,Block 1010,24,33.7322783,-84.3558997,24,22,2,22,17,2,1,0,0,2,0
1617,133363,1011,Block 1011,26,33.7326193,-84.3573764,26,24,2,24,22,2,0,0,0,0,0
1618,133364,1012,Block 1012,21,33.7312359,-84.3575223,21,17,4,17,14,3,0,0,0,0,0
1619,133365,1013,Block 1013,33,33.7306525,-84.355703,33,29,4,29,25,4,0,0,0,0,0
1620,133366,1014,Block 1014,21,33.7307763,-84.3528995,21,21,0,21,21,0,0,0,0,0,0
1621,133367,1015,Block 1015,34,33.7319788,-84.3530553,34,32,2,32,29,2,0,0,0,0,1
1622,133368,1016,Block 1016,2,33.7325929,-84.3541878,2,2,0,2,2,0,0,0,0,0,0
1623,133369,1017,Block 1017,24,33.7309609,-84.3511629,24,24,0,24,23,1,0,0,0,0,0
1624,133370,1018,Block 1018,18,33.7309862,-84.3499745,18,17,1,17,15,2,0,0,0,0,0
1625,133372,2000,Block 2000,30,33.7288375,-84.3500651,30,27,3,27,21,4,0,1,0,1,0
1626,133373,2001,Block 2001,39,33.7288625,-84.3515044,39,35,4,35,30,4,1,0,0,0,0
1627,133374,2002,Block 2002,62,33.7278671,-84.3537204,62,58,4,58,50,6,0,0,0,0,2
1628,133375,2003,Block 2003,23,33.7290973,-84.355209,23,23,0,23,20,2,0,0,0,0,1
1629,133376,2004,Block 2004,18,33.72911,-84.3565195,18,13,5,13,10,2,0,0,0,0,1
1630,133377,2005,Block 2005,28,33.728423,-84.3577668,28,28,0,28,26,2,0,0,0,0,0
1631,133378,2006,Block 2006,17,33.729387,-84.3589092,17,17,0,17,16,0,1,0,0,0,0
1632,133379,2007,Block 2007,60,33.730309,-84.359708,60,55,5,55,33,17,0,1,0,2,2
1633,133380,2008,Block 2008,30,33.7284078,-84.3629065,30,29,1,29,1,27,0,0,0,0,1
1634,133381,2009,Block 2009,32,33.7301831,-84.3608377,32,31,1,31,2,28,0,0,0,0,1
1635,133382,2010,Block 2010,23,33.7292818,-84.3611511,23,23,0,23,0,23,0,0,0,0,0
1636,133383,2011,Block 2011,22,33.728071,-84.3614465,22,22,0,22,0,21,1,0,0,0,0
1637,133384,2012,Block 2012,25,33.7272913,-84.3565187,25,23,2,23,23,0,0,0,0,0,0
1638,133385,2013,Block 2013,20,33.7269891,-84.3500948,20,17,3,17,14,3,0,0,0,0,0
1639,133386,2014,Block 2014,14,33.7270115,-84.3515447,14,13,1,13,10,1,0,1,0,0,1
1640,133387,2015,Block 2015,24,33.7254948,-84.3517385,24,24,0,24,20,3,1,0,0,0,0
1641,133388,2016,Block 2016,13,33.7252886,-84.3501065,13,13,0,13,11,1,0,0,0,0,1
1642,133389,2017,Block 2017,20,33.7277384,-84.3589275,20,20,0,20,15,1,1,1,0,0,2
1643,133393,3002,Block 3002,13,33.7455309,-84.3546553,13,10,3,10,3,4,0,0,0,3,0
1644,133394,3003,Block 3003,1,33.7455544,-84.3501603,1,1,0,1,1,0,0,0,0,0,0
1645,133398,3007,Block 3007,268,33.7435684,-84.3549887,268,202,66,202,57,124,1,8,0,2,10
1646,133399,3008,Block 3008,13,33.7428296,-84.3549982,13,11,2,11,6,4,0,0,0,1,0
1647,133400,3009,Block 3009,100,33.7437245,-84.3517006,100,80,20,80,49,30,0,0,0,0,1
1648,133403,3012,Block 3012,65,33.741262,-84.355777,65,53,12,53,38,11,0,3,0,0,1
1649,133404,3013,Block 3013,24,33.7401541,-84.3566274,24,22,2,22,18,1,0,2,0,0,1
1650,133406,3015,Block 3015,20,33.7424543,-84.3533822,20,16,4,16,11,5,0,0,0,0,0
1651,133407,3016,Block 3016,22,33.742686,-84.3514143,22,17,5,17,13,3,0,0,0,0,1
1652,133408,3017,Block 3017,10,33.7426961,-84.3498342,10,9,1,9,4,5,0,0,0,0,0
1653,133409,3018,Block 3018,9,33.7412274,-84.3498355,9,9,0,9,9,0,0,0,0,0,0
1654,133410,3019,Block 3019,20,33.7412325,-84.3508669,20,19,1,19,15,3,0,1,0,0,0
1655,133411,3020,Block 3020,22,33.7411959,-84.351859,22,18,4,18,12,5,0,0,0,0,1
1656,133412,3021,Block 3021,27,33.7411173,-84.3529483,27,25,2,25,12,9,0,4,0,0,0
1657,133413,3022,Block 3022,27,33.740987,-84.3539245,27,26,1,26,13,12,0,0,0,1,0
1658,133414,3023,Block 3023,30,33.7408872,-84.3548282,30,27,3,27,21,4,0,0,0,0,2
1659,133415,3024,Block 3024,227,33.7380567,-84.3568469,227,214,13,214,156,42,0,10,0,0,6
1660,133416,3025,Block 3025,16,33.7401541,-84.357659,16,15,1,15,9,5,0,0,0,0,1
1661,133417,3026,Block 3026,62,33.7412248,-84.3576087,62,58,4,58,43,13,0,1,0,0,1
1662,133418,3027,Block 3027,3,33.7421889,-84.356752,3,3,0,3,1,2,0,0,0,0,0
1663,133420,3029,Block 3029,15,33.7408829,-84.356627,15,13,2,13,9,2,0,0,0,0,2
1664,133422,3031,Block 3031,16,33.7398975,-84.3502748,16,14,2,14,12,2,0,0,0,0,0
1665,133423,3032,Block 3032,63,33.7384384,-84.353107,63,60,3,60,51,8,0,0,0,1,0
1666,133424,3033,Block 3033,16,33.7382734,-84.3543407,16,15,1,15,13,2,0,0,0,0,0
1667,133425,3034,Block 3034,29,33.7378277,-84.35063,29,26,3,26,19,7,0,0,0,0,0
1668,133426,3035,Block 3035,20,33.738915,-84.350293,20,17,3,17,13,3,0,1,0,0,0
1669,133427,3036,Block 3036,16,33.7367085,-84.3517511,16,16,0,16,15,0,0,0,0,0,1
1670,133428,3037,Block 3037,21,33.7367079,-84.3499623,21,18,3,18,16,2,0,0,0,0,0
1671,133432,1000,Block 1000,79,33.7352214,-84.360853,79,77,2,77,19,58,0,0,0,0,0
1672,133433,1001,Block 1001,9,33.7360153,-84.3619647,9,8,1,8,4,4,0,0,0,0,0
1673,133434,1002,Block 1002,45,33.7361825,-84.3646959,45,38,7,38,26,10,1,1,0,0,0
1674,133435,1003,Block 1003,26,33.7362055,-84.3674303,26,26,0,26,22,3,0,1,0,0,0
1675,133436,1004,Block 1004,14,33.7348365,-84.3645022,14,13,1,13,8,5,0,0,0,0,0
1676,133437,1005,Block 1005,45,33.7346619,-84.3668709,45,42,3,42,35,7,0,0,0,0,0
1677,133438,1006,Block 1006,32,33.7331661,-84.3626238,32,29,3,29,23,6,0,0,0,0,0
1678,133439,1007,Block 1007,32,33.7341486,-84.3619818,32,31,1,31,7,23,0,1,0,0,0
1679,133440,1008,Block 1008,22,33.7329548,-84.3654215,22,17,5,17,12,3,0,1,0,0,1
1680,133441,1009,Block 1009,28,33.7330725,-84.3665684,28,28,0,28,21,7,0,0,0,0,0
1681,133442,1010,Block 1010,29,33.7331058,-84.3676984,29,24,5,24,17,7,0,0,0,0,0
1682,133443,1011,Block 1011,29,33.7312794,-84.3676986,29,22,7,22,13,9,0,0,0,0,0
1683,133444,1012,Block 1012,25,33.7312559,-84.3664935,25,22,3,22,17,4,0,0,0,0,1
1684,133445,1013,Block 1013,24,33.731235,-84.3652768,24,23,1,23,19,3,0,1,0,0,0
1685,133446,1014,Block 1014,251,33.7309899,-84.3630694,251,229,22,229,130,87,0,5,0,3,4
1686,133447,1015,Block 1015,11,33.7298685,-84.367711,11,11,0,11,11,0,0,0,0,0,0
1687,133448,1016,Block 1016,15,33.7298548,-84.3664409,15,15,0,15,14,1,0,0,0,0,0
1688,133449,1017,Block 1017,16,33.7298372,-84.3651692,16,16,0,16,14,2,0,0,0,0,0
1689,133450,1018,Block 1018,111,33.7284064,-84.3652212,111,102,9,102,68,28,0,3,0,0,3
1690,133451,1019,Block 1019,17,33.7288955,-84.3673214,17,17,0,17,10,7,0,0,0,0,0
1691,133452,1020,Block 1020,22,33.7280203,-84.3673335,22,20,2,20,15,5,0,0,0,0,0
1692,133453,1021,Block 1021,18,33.7270825,-84.3672823,18,16,2,16,11,4,0,0,0,0,1
1693,133456,2001,Block 2001,20,33.7363337,-84.375042,20,11,9,11,10,1,0,0,0,0,0
1694,133457,2002,Block 2002,27,33.7361833,-84.3774425,27,25,2,25,20,3,0,0,0,0,2
1695,133458,2003,Block 2003,17,33.7361131,-84.3791393,17,14,3,14,6,7,0,1,0,0,0
1696,133459,2004,Block 2004,13,33.7354265,-84.3740308,13,10,3,10,10,0,0,0,0,0,0
1697,133460,2005,Block 2005,9,33.7354551,-84.374745,9,9,0,9,6,3,0,0,0,0,0
1698,133462,2007,Block 2007,25,33.7352113,-84.3774608,25,25,0,25,21,3,0,1,0,0,0
1699,133463,2008,Block 2008,12,33.7348998,-84.378823,12,9,3,9,6,2,0,0,0,0,1
1700,133464,2009,Block 2009,10,33.7349119,-84.3795368,10,9,1,9,2,6,1,0,0,0,0
1701,133465,2010,Block 2010,18,33.733718,-84.3795486,18,15,3,15,6,6,0,1,0,1,1
1702,133466,2011,Block 2011,14,33.7337143,-84.3788341,14,11,3,11,4,7,0,0,0,0,0
1703,133467,2012,Block 2012,22,33.7342634,-84.3774819,22,22,0,22,18,4,0,0,0,0,0
1704,133468,2013,Block 2013,19,33.7343154,-84.3758069,19,19,0,19,15,3,0,0,0,0,1
1705,133469,2014,Block 2014,22,33.7342814,-84.3747869,22,21,1,21,15,5,0,0,0,0,1
1706,133470,2015,Block 2015,17,33.7342478,-84.3740538,17,15,2,15,13,2,0,0,0,0,0
1707,133471,2016,Block 2016,28,33.7331233,-84.3750969,28,26,2,26,21,5,0,0,0,0,0
1708,133472,2017,Block 2017,14,33.7334482,-84.3775139,14,13,1,13,8,4,0,0,0,0,1
1709,133473,2018,Block 2018,14,33.7328695,-84.3774996,14,10,4,10,7,3,0,0,0,0,0
1710,133474,2019,Block 2019,3,33.7327267,-84.3791813,3,2,1,2,1,1,0,0,0,0,0
1711,133475,2020,Block 2020,17,33.7319308,-84.3791986,17,14,3,14,7,6,1,0,0,0,0
1712,133476,2021,Block 2021,25,33.732057,-84.3775408,25,20,5,20,12,7,0,0,0,0,1
1713,133477,2022,Block 2022,35,33.7319893,-84.3751183,35,25,10,25,19,6,0,0,0,0,0
1714,133478,2023,Block 2023,18,33.730872,-84.3758764,18,18,0,18,15,3,0,0,0,0,0
1715,133479,2024,Block 2024,25,33.7309008,-84.3775715,25,17,8,17,8,8,0,1,0,0,0
1716,133480,2025,Block 2025,19,33.7309253,-84.3792273,19,16,3,16,10,5,0,0,0,0,1
1717,133481,2026,Block 2026,19,33.7308377,-84.3743746,19,19,0,19,12,7,0,0,0,0,0
1718,133483,3000,Block 3000,36,33.7292741,-84.3694502,36,27,9,27,21,6,0,0,0,0,0
1719,133484,3001,Block 3001,35,33.7297567,-84.3720868,35,26,9,26,14,12,0,0,0,0,0
1720,133485,3002,Block 3002,20,33.7296644,-84.3743897,20,17,3,17,12,5,0,0,0,0,0
1721,133486,3003,Block 3003,13,33.7296899,-84.3758966,13,12,1,12,5,6,0,0,0,0,1
1722,133487,3004,Block 3004,38,33.729707,-84.3775851,38,36,2,36,26,8,0,1,0,0,1
1723,133488,3005,Block 3005,37,33.7282523,-84.3776077,37,34,3,34,30,3,0,1,0,0,0
1724,133489,3006,Block 3006,94,33.7265624,-84.3735787,94,86,8,86,52,29,0,1,0,2,2
1725,133490,3007,Block 3007,36,33.7279305,-84.3721076,36,30,6,30,14,15,0,0,0,1,0
1726,133491,3008,Block 3008,33,33.7288533,-84.3720825,33,30,3,30,18,10,0,0,0,0,2
1727,133492,3009,Block 3009,24,33.7258403,-84.3776437,24,17,7,17,8,7,0,0,0,0,2
1728,133493,3010,Block 3010,21,33.7279228,-84.3694728,21,18,3,18,9,8,0,0,0,0,1
1729,133496,1000,Block 1000,16,33.736128,-84.3804049,16,15,1,15,11,3,0,1,0,0,0
1730,133499,1003,Block 1003,11,33.7361873,-84.3845007,11,9,2,9,3,4,0,0,0,1,1
1731,133500,1004,Block 1004,9,33.7361957,-84.3852168,9,8,1,8,2,6,0,0,0,0,0
1732,133501,1005,Block 1005,5,33.736204,-84.3859569,5,4,1,4,0,4,0,0,0,0,0
1733,133502,1006,Block 1006,2,33.7362171,-84.387112,2,1,1,1,0,1,0,0,0,0,0
1734,133503,1007,Block 1007,2,33.7350114,-84.3871273,2,2,0,2,0,2,0,0,0,0,0
1735,133504,1008,Block 1008,12,33.7350006,-84.385815,12,5,7,5,0,5,0,0,0,0,0
1736,133505,1009,Block 1009,16,33.7349895,-84.3850032,16,13,3,13,1,12,0,0,0,0,0
1737,133506,1010,Block 1010,8,33.7349974,-84.3844484,8,4,4,4,0,4,0,0,0,0,0
1738,133507,1011,Block 1011,13,33.7340628,-84.383257,13,8,5,8,0,7,0,0,0,0,1
1739,133508,1012,Block 1012,13,33.7337723,-84.3845098,13,9,4,9,1,8,0,0,0,0,0
1740,133509,1013,Block 1013,43,33.733778,-84.3856112,43,22,21,22,2,16,0,2,0,0,2
1741,133510,1014,Block 1014,5,33.7337898,-84.3871443,5,4,1,4,1,2,0,0,0,1,0
1742,133511,1015,Block 1015,36,33.7324354,-84.3871506,36,25,11,25,0,15,0,8,0,2,0
1743,133512,1016,Block 1016,34,33.7324127,-84.3853538,34,25,9,25,4,20,0,0,0,1,0
1744,133513,1017,Block 1017,48,33.7327454,-84.3826616,48,31,17,31,9,20,0,0,0,0,2
1745,133514,1018,Block 1018,12,33.7327363,-84.3804464,12,6,6,6,3,2,0,1,0,0,0
1746,133515,1019,Block 1019,17,33.7337273,-84.3804348,17,11,6,11,3,6,0,1,0,0,1
1747,133516,1020,Block 1020,21,33.7349256,-84.3804143,21,17,4,17,4,9,0,3,0,0,1
1748,133517,1021,Block 1021,12,33.7310507,-84.3871231,12,11,1,11,2,8,0,1,0,0,0
1749,133518,1022,Block 1022,16,33.7310345,-84.3853363,16,13,3,13,4,8,0,0,0,0,1
1750,133519,1023,Block 1023,14,33.7310008,-84.3838018,14,14,0,14,4,9,0,0,0,0,1
1751,133520,1024,Block 1024,41,33.7319842,-84.3826435,41,13,28,13,4,9,0,0,0,0,0
1752,133521,1025,Block 1025,13,33.7319539,-84.3804491,13,12,1,12,5,6,0,1,0,0,0
1753,133522,1026,Block 1026,14,33.7309493,-84.3804681,14,13,1,13,4,9,0,0,0,0,0
1754,133523,1027,Block 1027,26,33.7309753,-84.3821165,26,20,6,20,9,11,0,0,0,0,0
1755,133525,2000,Block 2000,134,33.7295153,-84.380566,134,118,16,118,12,101,0,0,1,1,3
1756,133526,2001,Block 2001,12,33.7298792,-84.3838221,12,7,5,7,1,6,0,0,0,0,0
1757,133527,2002,Block 2002,19,33.729901,-84.3853068,19,14,5,14,2,12,0,0,0,0,0
1758,133528,2003,Block 2003,41,33.7299029,-84.3870818,41,34,7,34,2,32,0,0,0,0,0
1759,133529,2004,Block 2004,81,33.7287093,-84.3873068,81,74,7,74,6,63,0,1,0,0,4
1760,133530,2005,Block 2005,39,33.7279564,-84.3846741,39,33,6,33,4,29,0,0,0,0,0
1761,133531,2006,Block 2006,40,33.7279471,-84.3837332,40,19,21,19,6,13,0,0,0,0,0
1762,133532,2007,Block 2007,31,33.7289525,-84.3822633,31,22,9,22,5,17,0,0,0,0,0
1763,133534,2009,Block 2009,23,33.7276946,-84.3810139,23,18,5,18,0,16,0,1,0,1,0
1764,133535,2010,Block 2010,30,33.7275779,-84.3801246,30,11,19,11,5,4,0,2,0,0,0
1765,133536,2011,Block 2011,23,33.727522,-84.3791099,23,17,6,17,7,10,0,0,0,0,0
1766,133537,2012,Block 2012,126,33.7252505,-84.382547,126,72,54,72,18,54,0,0,0,0,0
1767,133538,2013,Block 2013,12,33.7259503,-84.3847079,12,5,7,5,0,5,0,0,0,0,0
1768,133539,2014,Block 2014,5,33.7260045,-84.3875642,5,5,0,5,0,5,0,0,0,0,0
1769,133540,2015,Block 2015,22,33.7259932,-84.3866132,22,21,1,21,0,19,0,0,0,1,1
1770,133541,2016,Block 2016,16,33.7253351,-84.3801295,16,9,7,9,0,9,0,0,0,0,0
1771,133542,2017,Block 2017,14,33.7259328,-84.3837812,14,14,0,14,0,14,0,0,0,0,0
1772,133543,2018,Block 2018,14,33.7259716,-84.3856641,14,13,1,13,1,12,0,0,0,0,0
1773,133545,2020,Block 2020,26,33.7274648,-84.3856293,26,23,3,23,2,20,0,0,0,0,1
1774,133546,2021,Block 2021,21,33.7274887,-84.3865739,21,13,8,13,0,11,0,1,0,0,1
1775,133549,1000,Block 1000,173,33.7220345,-84.3809383,173,142,31,142,26,106,0,0,0,1,9
1776,133551,1002,Block 1002,11,33.7214715,-84.3818388,11,9,2,9,0,8,0,1,0,0,0
1777,133552,1003,Block 1003,13,33.7195031,-84.3836765,13,12,1,12,0,11,0,1,0,0,0
1778,133553,1004,Block 1004,14,33.7195523,-84.3843654,14,14,0,14,1,13,0,0,0,0,0
1779,133554,1005,Block 1005,9,33.7190667,-84.3857509,9,5,4,5,0,4,0,0,0,0,1
1780,133555,1006,Block 1006,6,33.7183759,-84.384346,6,3,3,3,1,2,0,0,0,0,0
1781,133556,1007,Block 1007,351,33.7178052,-84.3895479,351,303,48,303,8,287,0,0,0,0,8
1782,133557,1008,Block 1008,13,33.7149922,-84.3865497,13,8,5,8,1,7,0,0,0,0,0
1783,133558,1009,Block 1009,8,33.7159016,-84.3865406,8,4,4,4,0,4,0,0,0,0,0
1784,133559,1010,Block 1010,15,33.7140853,-84.3876652,15,9,6,9,0,9,0,0,0,0,0
1785,133560,1011,Block 1011,13,33.7140838,-84.3865639,13,9,4,9,0,9,0,0,0,0,0
1786,133561,1012,Block 1012,22,33.7141672,-84.3850841,22,14,8,14,0,13,0,0,0,1,0
1787,133562,1013,Block 1013,9,33.7150575,-84.3852494,9,9,0,9,0,9,0,0,0,0,0
1788,133563,1014,Block 1014,10,33.7159471,-84.3854155,10,6,4,6,1,5,0,0,0,0,0
1789,133564,1015,Block 1015,14,33.7168017,-84.3860525,14,9,5,9,0,9,0,0,0,0,0
1790,133565,1016,Block 1016,14,33.7171049,-84.384738,14,8,6,8,0,8,0,0,0,0,0
1791,133566,1017,Block 1017,9,33.7180148,-84.3851338,9,5,4,5,0,5,0,0,0,0,0
1792,133567,1018,Block 1018,12,33.7178326,-84.3838135,12,6,6,6,0,6,0,0,0,0,0
1793,133568,1019,Block 1019,3,33.7165698,-84.3827414,3,0,3,0,0,0,0,0,0,0,0
1794,133569,1020,Block 1020,12,33.7166787,-84.3809378,12,6,6,6,0,6,0,0,0,0,0
1795,133570,1021,Block 1021,19,33.7153043,-84.3803927,19,13,6,13,4,9,0,0,0,0,0
1796,133571,1022,Block 1022,1,33.7149323,-84.3821603,1,0,1,0,0,0,0,0,0,0,0
1797,133572,1023,Block 1023,6,33.7153646,-84.3840035,6,3,3,3,0,3,0,0,0,0,0
1798,133573,1024,Block 1024,14,33.716224,-84.3843612,14,8,6,8,0,8,0,0,0,0,0
1799,133574,1025,Block 1025,8,33.7138685,-84.3899599,8,7,1,7,0,7,0,0,0,0,0
1800,133575,1026,Block 1026,106,33.7135642,-84.3888036,106,100,6,100,2,98,0,0,0,0,0
1801,133576,1027,Block 1027,11,33.7131798,-84.3876815,11,7,4,7,0,6,0,0,0,0,1
1802,133577,1028,Block 1028,14,33.7131771,-84.3865763,14,11,3,11,3,8,0,0,0,0,0
1803,133578,1029,Block 1029,22,33.713289,-84.3849207,22,12,10,12,0,12,0,0,0,0,0
1804,133579,1030,Block 1030,5,33.7136454,-84.3833124,5,1,4,1,0,0,0,0,0,0,1
1805,133580,1031,Block 1031,12,33.7145115,-84.3836553,12,5,7,5,0,5,0,0,0,0,0
1806,133581,1032,Block 1032,191,33.7128159,-84.3912534,191,168,23,168,1,165,0,0,0,0,2
1807,133582,1033,Block 1033,140,33.7148701,-84.3926481,140,137,3,137,0,136,1,0,0,0,0
1808,133584,1035,Block 1035,1,33.7085271,-84.3908169,1,1,0,1,0,1,0,0,0,0,0
1809,133588,1039,Block 1039,46,33.7119129,-84.3890025,46,40,6,40,0,40,0,0,0,0,0
1810,133599,1007,Block 1007,13,33.733349,-84.4073758,13,10,3,10,1,9,0,0,0,0,0
1811,133600,1008,Block 1008,28,33.7335461,-84.4060448,28,16,12,16,0,15,0,0,0,1,0
1812,133601,1009,Block 1009,42,33.7332239,-84.405065,42,19,23,19,0,19,0,0,0,0,0
1813,133602,1010,Block 1010,47,33.733176,-84.4042335,47,25,22,25,1,23,0,0,0,1,0
1814,133603,1011,Block 1011,370,33.7332029,-84.4027576,370,353,17,353,2,345,0,0,0,1,5
1815,133604,1012,Block 1012,12,33.7321167,-84.4006131,12,8,4,8,0,8,0,0,0,0,0
1816,133606,1014,Block 1014,4,33.7277955,-84.39762,4,2,2,2,0,2,0,0,0,0,0
1817,133607,1015,Block 1015,19,33.7299114,-84.3996091,19,11,8,11,0,11,0,0,0,0,0
1818,133608,1016,Block 1016,14,33.7299125,-84.4004021,14,9,5,9,1,8,0,0,0,0,0
1819,133609,1017,Block 1017,24,33.7299129,-84.4012065,24,10,14,10,0,10,0,0,0,0,0
1820,133610,1018,Block 1018,20,33.7312181,-84.4012552,20,12,8,12,1,11,0,0,0,0,0
1821,133611,1019,Block 1019,15,33.732534,-84.4013054,15,3,12,3,0,3,0,0,0,0,0
1822,133612,1020,Block 1020,11,33.7305892,-84.4054762,11,9,2,9,0,9,0,0,0,0,0
1823,133613,1021,Block 1021,18,33.7323379,-84.4063336,18,9,9,9,0,9,0,0,0,0,0
1824,133614,1022,Block 1022,27,33.7312425,-84.40655,27,11,16,11,1,10,0,0,0,0,0
1825,133615,1023,Block 1023,17,33.7312433,-84.4075686,17,10,7,10,3,6,0,0,0,0,1
1826,133616,1024,Block 1024,35,33.7299486,-84.4070225,35,13,22,13,3,10,0,0,0,0,0
1827,133617,1025,Block 1025,27,33.7302872,-84.4044461,27,10,17,10,0,10,0,0,0,0,0
1828,133618,1026,Block 1026,12,33.7315293,-84.4044253,12,7,5,7,0,7,0,0,0,0,0
1829,133619,1027,Block 1027,45,33.7299954,-84.4035597,45,30,15,30,0,29,0,0,0,0,1
1830,133620,1028,Block 1028,11,33.7312064,-84.4028532,11,8,3,8,0,7,0,0,0,0,1
1831,133621,1029,Block 1029,26,33.7312231,-84.4021534,26,16,10,16,0,16,0,0,0,0,0
1832,133622,1030,Block 1030,19,33.7287327,-84.4054115,19,8,11,8,0,8,0,0,0,0,0
1833,133623,1031,Block 1031,17,33.728734,-84.4064873,17,10,7,10,0,10,0,0,0,0,0
1834,133625,1033,Block 1033,8,33.7299114,-84.4027913,8,6,2,6,0,6,0,0,0,0,0
1835,133626,1034,Block 1034,5,33.7299073,-84.4020075,5,5,0,5,0,5,0,0,0,0,0
1836,133627,1035,Block 1035,21,33.7287231,-84.4044151,21,14,7,14,1,13,0,0,0,0,0
1837,133647,1017,Block 1017,8,33.7363108,-84.4102664,8,4,4,4,0,4,0,0,0,0,0
1838,133651,1021,Block 1021,18,33.7385829,-84.4088713,18,18,0,18,5,13,0,0,0,0,0
1839,133653,1023,Block 1023,13,33.731621,-84.4118653,13,12,1,12,0,12,0,0,0,0,0
1840,133654,1024,Block 1024,25,33.728844,-84.4124147,25,17,8,17,4,10,0,0,0,3,0
1841,133656,1026,Block 1026,16,33.7336047,-84.411019,16,13,3,13,0,13,0,0,0,0,0
1842,133657,1027,Block 1027,19,33.7340302,-84.4093014,19,13,6,13,0,13,0,0,0,0,0
1843,133658,1028,Block 1028,19,33.7332475,-84.4092989,19,13,6,13,2,11,0,0,0,0,0
1844,133659,1029,Block 1029,26,33.7307342,-84.4121254,26,22,4,22,0,22,0,0,0,0,0
1845,133660,1030,Block 1030,19,33.7303708,-84.4098609,19,16,3,16,3,11,0,1,0,0,1
1846,133661,1031,Block 1031,24,33.7320072,-84.4098923,24,18,6,18,1,17,0,0,0,0,0
1847,133662,1032,Block 1032,17,33.7320089,-84.4087032,17,10,7,10,0,9,0,1,0,0,0
1848,133663,1033,Block 1033,21,33.7304009,-84.408661,21,8,13,8,0,8,0,0,0,0,0
1849,133664,1034,Block 1034,36,33.7289832,-84.4096032,36,29,7,29,3,25,0,0,0,0,1
1850,133665,1035,Block 1035,31,33.7298336,-84.4121063,31,18,13,18,2,15,0,0,0,0,1
1851,133667,1037,Block 1037,17,33.7271006,-84.4148324,17,12,5,12,0,12,0,0,0,0,0
1852,133672,1042,Block 1042,21,33.7277578,-84.4142376,21,12,9,12,1,10,0,0,0,0,1
1853,133673,1043,Block 1043,42,33.7277291,-84.4124307,42,33,9,33,5,25,0,0,0,0,3
1854,133674,1044,Block 1044,48,33.7277626,-84.4096063,48,34,14,34,9,25,0,0,0,0,0
1855,133675,1045,Block 1045,31,33.7265254,-84.4095762,31,23,8,23,6,17,0,0,0,0,0
1856,133676,1046,Block 1046,44,33.7264938,-84.4124,44,32,12,32,5,26,0,0,0,0,1
1857,133677,1047,Block 1047,40,33.7244508,-84.4102516,40,30,10,30,1,25,0,3,0,1,0
1858,133678,1048,Block 1048,39,33.7253468,-84.4093503,39,32,7,32,8,24,0,0,0,0,0
1859,133681,1051,Block 1051,155,33.723403,-84.410728,155,89,66,89,5,55,0,24,0,5,0
1860,133685,1000,Block 1000,70,33.7445599,-84.4399661,70,55,15,55,7,47,0,0,0,0,1
1861,133686,1001,Block 1001,37,33.7416047,-84.4442688,37,32,5,32,0,32,0,0,0,0,0
1862,133687,1002,Block 1002,53,33.7428598,-84.4436274,53,41,12,41,0,41,0,0,0,0,0
1863,133688,1003,Block 1003,11,33.7429147,-84.4403938,11,11,0,11,1,10,0,0,0,0,0
1864,133689,1004,Block 1004,46,33.7426831,-84.4389926,46,34,12,34,7,27,0,0,0,0,0
1865,133690,1005,Block 1005,45,33.7419369,-84.4375161,45,34,11,34,2,31,0,0,0,1,0
1866,133691,1006,Block 1006,4,33.7413716,-84.4361194,4,3,1,3,0,2,1,0,0,0,0
1867,133692,1007,Block 1007,21,33.7416121,-84.4404223,21,15,6,15,0,15,0,0,0,0,0
1868,133693,1008,Block 1008,24,33.741661,-84.4419471,24,21,3,21,0,20,0,0,0,0,1
1869,133695,2000,Block 2000,37,33.7401107,-84.4355132,37,27,10,27,0,26,0,1,0,0,0
1870,133696,2001,Block 2001,29,33.7402484,-84.437835,29,24,5,24,3,21,0,0,0,0,0
1871,133698,2003,Block 2003,82,33.7403099,-84.4427323,82,67,15,67,3,64,0,0,0,0,0
1872,133699,2004,Block 2004,38,33.7388441,-84.4355807,38,27,11,27,0,26,1,0,0,0,0
1873,133700,2005,Block 2005,23,33.7391814,-84.438186,23,18,5,18,1,17,0,0,0,0,0
1874,133701,2006,Block 2006,23,33.7391123,-84.4402333,23,16,7,16,2,14,0,0,0,0,0
1875,133702,2007,Block 2007,20,33.7390273,-84.4420869,20,20,0,20,1,18,0,0,0,1,0
1876,133703,2008,Block 2008,32,33.7391294,-84.4445633,32,27,5,27,1,26,0,0,0,0,0
1877,133704,2009,Block 2009,64,33.7379356,-84.4440644,64,51,13,51,3,48,0,0,0,0,0
1878,133705,2010,Block 2010,37,33.7379814,-84.4396158,37,31,6,31,1,29,0,0,0,0,1
1879,133706,2011,Block 2011,27,33.7377606,-84.4371121,27,16,11,16,0,12,2,0,0,0,2
1880,133708,3000,Block 3000,82,33.7366153,-84.4389573,82,67,15,67,8,57,1,0,0,0,1
1881,133709,3001,Block 3001,50,33.7368005,-84.4448077,50,41,9,41,1,40,0,0,0,0,0
1882,133710,3002,Block 3002,31,33.7359483,-84.4447502,31,23,8,23,0,23,0,0,0,0,0
1883,133711,3003,Block 3003,30,33.7357718,-84.4395704,30,26,4,26,2,22,0,0,0,0,2
1884,133712,3004,Block 3004,28,33.7350727,-84.4453301,28,22,6,22,0,22,0,0,0,0,0
1885,133713,3005,Block 3005,39,33.7351419,-84.4418103,39,37,2,37,0,35,0,0,0,1,1
1886,133714,3006,Block 3006,37,33.7350425,-84.4386132,37,25,12,25,2,22,0,0,0,0,1
1887,133715,3007,Block 3007,62,33.7342476,-84.4378539,62,45,17,45,0,44,0,0,0,0,1
1888,133716,3008,Block 3008,17,33.7340653,-84.439611,17,13,4,13,2,10,0,1,0,0,0
1889,133717,3009,Block 3009,38,33.7341076,-84.4456275,38,31,7,31,0,30,0,0,0,0,1
1890,133718,3010,Block 3010,31,33.7342868,-84.4426761,31,24,7,24,0,24,0,0,0,0,0
1891,133720,4000,Block 4000,199,33.7358669,-84.4304505,199,190,9,190,2,181,0,0,0,0,7
1892,133721,4001,Block 4001,7,33.7340486,-84.4299558,7,7,0,7,1,6,0,0,0,0,0
1893,133722,4002,Block 4002,19,33.736018,-84.4334137,19,14,5,14,0,14,0,0,0,0,0
1894,133723,4003,Block 4003,24,33.735576,-84.4320859,24,20,4,20,0,19,0,0,0,0,1
1895,133724,4004,Block 4004,52,33.7336427,-84.42863,52,48,4,48,0,46,0,0,0,0,2
1896,133725,4005,Block 4005,33,33.7372708,-84.4347844,33,23,10,23,0,22,0,0,0,0,1
1897,133726,4006,Block 4006,32,33.7364166,-84.4349609,32,23,9,23,5,18,0,0,0,0,0
1898,133727,4007,Block 4007,28,33.7355272,-84.4351531,28,18,10,18,0,18,0,0,0,0,0
1899,133728,4008,Block 4008,25,33.7341633,-84.4362191,25,14,11,14,0,13,0,0,0,1,0
1900,133729,4009,Block 4009,29,33.7341956,-84.4346299,29,10,19,10,1,9,0,0,0,0,0
1901,133730,4010,Block 4010,36,33.7341644,-84.4327522,36,29,7,29,1,28,0,0,0,0,0
1902,133731,4011,Block 4011,23,33.734157,-84.4310597,23,18,5,18,0,18,0,0,0,0,0
1903,133734,1000,Block 1000,24,33.7325875,-84.4282679,24,21,3,21,2,19,0,0,0,0,0
1904,133735,1001,Block 1001,30,33.732637,-84.4305231,30,22,8,22,1,20,0,0,0,0,1
1905,133736,1002,Block 1002,36,33.732682,-84.4327788,36,31,5,31,3,28,0,0,0,0,0
1906,133737,1003,Block 1003,31,33.7327319,-84.4350528,31,26,5,26,0,26,0,0,0,0,0
1907,133738,1004,Block 1004,34,33.732108,-84.4367918,34,13,21,13,0,13,0,0,0,0,0
1908,133739,1005,Block 1005,28,33.7314963,-84.4350698,28,15,13,15,0,14,0,0,0,1,0
1909,133740,1006,Block 1006,29,33.7314597,-84.4327927,29,21,8,21,0,21,0,0,0,0,0
1910,133741,1007,Block 1007,44,33.7314099,-84.4294431,44,33,11,33,0,33,0,0,0,0,0
1911,133742,1008,Block 1008,17,33.7311886,-84.4265158,17,13,4,13,0,13,0,0,0,0,0
1912,133743,1009,Block 1009,29,33.7320023,-84.4261025,29,23,6,23,0,23,0,0,0,0,0
1913,133745,2000,Block 2000,16,33.7301822,-84.4288789,16,12,4,12,0,12,0,0,0,0,0
1914,133746,2001,Block 2001,15,33.7299024,-84.4335958,15,13,2,13,1,12,0,0,0,0,0
1915,133747,2002,Block 2002,48,33.7287616,-84.436254,48,31,17,31,3,27,0,0,0,0,1
1916,133748,2003,Block 2003,16,33.730268,-84.4369573,16,10,6,10,1,9,0,0,0,0,0
1917,133749,2004,Block 2004,125,33.726322,-84.432437,125,96,29,96,2,94,0,0,0,0,0
1918,133750,2005,Block 2005,17,33.7273295,-84.4321875,17,11,6,11,0,11,0,0,0,0,0
1919,133751,2006,Block 2006,13,33.7273089,-84.4311517,13,9,4,9,0,9,0,0,0,0,0
1920,133752,2007,Block 2007,20,33.7277051,-84.4284204,20,15,5,15,0,15,0,0,0,0,0
1921,133753,2008,Block 2008,21,33.7268895,-84.4289258,21,12,9,12,2,10,0,0,0,0,0
1922,133754,2009,Block 2009,51,33.7237755,-84.4336398,51,42,9,42,0,41,0,0,0,0,1
1923,133755,2010,Block 2010,28,33.7246367,-84.4302691,28,25,3,25,0,25,0,0,0,0,0
1924,133756,2011,Block 2011,5,33.7273723,-84.4331594,5,3,2,3,0,2,1,0,0,0,0
1925,133757,2012,Block 2012,48,33.7246576,-84.433662,48,35,13,35,1,34,0,0,0,0,0
1926,133758,2013,Block 2013,48,33.7255241,-84.4335507,48,42,6,42,0,42,0,0,0,0,0
1927,133759,2014,Block 2014,14,33.7277416,-84.4300623,14,10,4,10,0,10,0,0,0,0,0
1928,133760,2015,Block 2015,49,33.722879,-84.4336163,49,40,9,40,0,40,0,0,0,0,0
1929,133761,2016,Block 2016,47,33.7238576,-84.4293645,47,35,12,35,2,33,0,0,0,0,0
1930,133762,2017,Block 2017,41,33.7240761,-84.4279981,41,31,10,31,1,30,0,0,0,0,0
1931,133764,3000,Block 3000,20,33.7276999,-84.4397508,20,11,9,11,1,10,0,0,0,0,0
1932,133766,3002,Block 3002,49,33.7273397,-84.4411891,49,35,14,35,0,35,0,0,0,0,0
1933,133767,3003,Block 3003,21,33.7243824,-84.4388032,21,16,5,16,0,16,0,0,0,0,0
1934,133768,3004,Block 3004,24,33.7259658,-84.4386014,24,19,5,19,0,19,0,0,0,0,0
1935,133769,3005,Block 3005,82,33.7249862,-84.4408129,82,59,23,59,1,57,0,0,0,0,1
1936,133770,3006,Block 3006,30,33.7237852,-84.4418198,30,25,5,25,2,23,0,0,0,0,0
1937,133771,3007,Block 3007,119,33.7248857,-84.4440982,119,114,5,114,3,108,0,0,1,0,2
1938,133772,3008,Block 3008,20,33.725902,-84.4455114,20,19,1,19,1,18,0,0,0,0,0
1939,133773,3009,Block 3009,33,33.7251484,-84.4482904,33,29,4,29,1,26,1,0,0,0,1
1940,133774,3010,Block 3010,39,33.724093,-84.447942,39,29,10,29,0,29,0,0,0,0,0
1941,133775,3011,Block 3011,32,33.7233379,-84.4464844,32,24,8,24,0,23,0,0,0,0,1
1942,133777,4000,Block 4000,22,33.7330638,-84.4395654,22,18,4,18,0,17,0,0,0,0,1
1943,133778,4001,Block 4001,19,33.7334127,-84.4430276,19,16,3,16,0,16,0,0,0,0,0
1944,133779,4002,Block 4002,20,33.7329164,-84.4434352,20,15,5,15,0,15,0,0,0,0,0
1945,133780,4003,Block 4003,34,33.7320355,-84.4433489,34,30,4,30,2,28,0,0,0,0,0
1946,133781,4004,Block 4004,16,33.7312281,-84.4408066,16,12,4,12,1,11,0,0,0,0,0
1947,133782,4005,Block 4005,8,33.7320464,-84.4379715,8,2,6,2,0,2,0,0,0,0,0
1948,133783,4006,Block 4006,28,33.730842,-84.4385665,28,16,12,16,0,16,0,0,0,0,0
1949,133784,4007,Block 4007,4,33.7301131,-84.4380611,4,2,2,2,0,2,0,0,0,0,0
1950,133785,4008,Block 4008,40,33.7295683,-84.4387857,40,26,14,26,1,25,0,0,0,0,0
1951,133786,4009,Block 4009,47,33.7285858,-84.4393586,47,27,20,27,1,26,0,0,0,0,0
1952,133787,4010,Block 4010,18,33.7295501,-84.4425911,18,15,3,15,0,15,0,0,0,0,0
1953,133788,4011,Block 4011,31,33.7307507,-84.4439364,31,31,0,31,0,31,0,0,0,0,0
1954,133789,4012,Block 4012,11,33.7302083,-84.4457912,11,9,2,9,0,9,0,0,0,0,0
1955,133791,4014,Block 4014,31,33.7288023,-84.4442275,31,28,3,28,0,27,1,0,0,0,0
1956,133794,1000,Block 1000,36,33.7328462,-84.4159875,36,27,9,27,2,24,0,0,0,1,0
1957,133795,1001,Block 1001,19,33.7328153,-84.4183909,19,13,6,13,0,13,0,0,0,0,0
1958,133796,1002,Block 1002,18,33.7328018,-84.4197734,18,11,7,11,1,10,0,0,0,0,0
1959,133798,1004,Block 1004,18,33.7317272,-84.4186035,18,12,6,12,1,10,0,0,0,0,1
1960,133799,1005,Block 1005,34,33.7316093,-84.4159799,34,26,8,26,1,23,0,0,0,0,2
1961,133800,1006,Block 1006,14,33.7303745,-84.4161693,14,11,3,11,2,9,0,0,0,0,0
1962,133804,1010,Block 1010,15,33.7310441,-84.424504,15,12,3,12,0,11,0,0,0,0,1
1963,133805,1011,Block 1011,44,33.7289676,-84.4224524,44,27,17,27,1,26,0,0,0,0,0
1964,133806,1012,Block 1012,29,33.7301548,-84.4245118,29,21,8,21,0,21,0,0,0,0,0
1965,133807,1013,Block 1013,24,33.7301849,-84.4264435,24,20,4,20,0,19,0,1,0,0,0
1966,133808,1014,Block 1014,19,33.7291714,-84.4264664,19,14,5,14,2,12,0,0,0,0,0
1967,133809,1015,Block 1015,32,33.7291305,-84.424525,32,21,11,21,1,20,0,0,0,0,0
1968,133810,1016,Block 1016,30,33.7276249,-84.4241716,30,19,11,19,0,19,0,0,0,0,0
1969,133811,1017,Block 1017,13,33.7282893,-84.4259267,13,9,4,9,0,9,0,0,0,0,0
1970,133812,1018,Block 1018,58,33.726586,-84.4259952,58,29,29,29,0,27,1,0,0,0,1
1971,133814,2000,Block 2000,31,33.7279701,-84.4200292,31,22,9,22,0,22,0,0,0,0,0
1972,133815,2001,Block 2001,30,33.7269386,-84.4203751,30,23,7,23,0,23,0,0,0,0,0
1973,133816,2002,Block 2002,40,33.7263169,-84.4212256,40,28,12,28,0,28,0,0,0,0,0
1974,133817,2003,Block 2003,38,33.7254873,-84.4220519,38,16,22,16,2,14,0,0,0,0,0
1975,133818,2004,Block 2004,25,33.7246364,-84.4230484,25,12,13,12,1,11,0,0,0,0,0
1976,133819,2005,Block 2005,21,33.7239753,-84.4238749,21,13,8,13,2,11,0,0,0,0,0
1977,133820,2006,Block 2006,14,33.7238139,-84.4247344,14,12,2,12,0,12,0,0,0,0,0
1978,133821,2007,Block 2007,11,33.7245623,-84.4257797,11,3,8,3,0,3,0,0,0,0,0
1979,133822,2008,Block 2008,22,33.7246965,-84.4267795,22,17,5,17,0,16,0,0,0,1,0
1980,133823,2009,Block 2009,25,33.7231393,-84.4263519,25,11,14,11,0,11,0,0,0,0,0
1981,133824,2010,Block 2010,23,33.7227832,-84.4241531,23,16,7,16,0,15,0,0,0,0,1
1982,133825,2011,Block 2011,1,33.7270633,-84.4183486,1,1,0,1,0,0,0,0,0,1,0
1983,133828,1000,Block 1000,2,33.725337,-84.3941878,2,2,0,2,1,1,0,0,0,0,0
1984,133829,1001,Block 1001,20,33.7259923,-84.3951198,20,9,11,9,1,7,0,0,0,0,1
1985,133830,1002,Block 1002,16,33.7261141,-84.396267,16,11,5,11,2,9,0,0,0,0,0
1986,133831,1003,Block 1003,10,33.7261181,-84.3971342,10,4,6,4,0,3,1,0,0,0,0
1987,133832,1004,Block 1004,15,33.7261244,-84.3979884,15,4,11,4,0,4,0,0,0,0,0
1988,133833,1005,Block 1005,105,33.7249242,-84.3971283,105,89,16,89,1,86,0,0,0,0,2
1989,133834,1006,Block 1006,16,33.7249363,-84.3988293,16,10,6,10,1,9,0,0,0,0,0
1990,133835,1007,Block 1007,18,33.724939,-84.3996316,18,10,8,10,0,10,0,0,0,0,0
1991,133836,1008,Block 1008,12,33.7249408,-84.4004205,12,8,4,8,0,8,0,0,0,0,0
1992,133837,1009,Block 1009,30,33.7249421,-84.401223,30,13,17,13,0,13,0,0,0,0,0
1993,133838,1010,Block 1010,15,33.7249486,-84.402023,15,9,6,9,1,8,0,0,0,0,0
1994,133839,1011,Block 1011,21,33.7249529,-84.4027994,21,16,5,16,0,16,0,0,0,0,0
1995,133840,1012,Block 1012,17,33.724961,-84.4035819,17,6,11,6,1,5,0,0,0,0,0
1996,133841,1013,Block 1013,15,33.7263031,-84.4035828,15,8,7,8,0,8,0,0,0,0,0
1997,133842,1014,Block 1014,36,33.7241166,-84.3950526,36,24,12,24,0,24,0,0,0,0,0
1998,133846,1018,Block 1018,19,33.7235264,-84.4028155,19,12,7,12,0,12,0,0,0,0,0
1999,133847,1019,Block 1019,14,33.7235311,-84.4035967,14,7,7,7,0,6,0,0,0,0,1
2000,133848,1020,Block 1020,12,33.7235374,-84.4043907,12,7,5,7,1,5,0,0,0,1,0
2001,133849,1021,Block 1021,18,33.7249706,-84.4043999,18,12,6,12,0,11,0,0,0,0,1
2002,133850,1022,Block 1022,12,33.7248626,-84.4052316,12,11,1,11,0,11,0,0,0,0,0
2003,133851,1023,Block 1023,33,33.7252097,-84.4066702,33,26,7,26,1,25,0,0,0,0,0
2004,133852,1024,Block 1024,32,33.7234317,-84.4068856,32,27,5,27,3,23,0,0,0,1,0
2005,133853,1025,Block 1025,21,33.7231962,-84.4053453,21,14,7,14,0,12,0,1,0,0,1
2006,133854,1026,Block 1026,16,33.722492,-84.4028365,16,12,4,12,0,12,0,0,0,0,0
2007,133855,1027,Block 1027,40,33.7231726,-84.4020445,40,26,14,26,0,22,0,1,0,0,3
2008,133856,1028,Block 1028,36,33.7231625,-84.4012464,36,26,10,26,0,25,0,0,0,1,0
2009,133857,1029,Block 1029,21,33.723166,-84.4004438,21,15,6,15,0,15,0,0,0,0,0
2010,133858,1030,Block 1030,49,33.7231599,-84.3996519,49,29,20,29,0,28,0,0,0,1,0
2011,133859,1031,Block 1031,28,33.7231597,-84.3988552,28,14,14,14,2,12,0,0,0,0,0
2012,133860,1032,Block 1032,29,33.7231423,-84.3980291,29,19,10,19,0,19,0,0,0,0,0
2013,133861,1033,Block 1033,32,33.7231522,-84.3971703,32,21,11,21,2,19,0,0,0,0,0
2014,133862,1034,Block 1034,15,33.7230187,-84.3961014,15,8,7,8,0,8,0,0,0,0,0
2015,133863,1035,Block 1035,18,33.721154,-84.4007849,18,16,2,16,0,16,0,0,0,0,0
2016,133864,1036,Block 1036,9,33.722501,-84.4044085,9,6,3,6,0,5,0,1,0,0,0
2017,133865,1037,Block 1037,3,33.7224964,-84.4036183,3,3,0,3,0,3,0,0,0,0,0
2018,133874,1046,Block 1046,2,33.7212903,-84.4069033,2,0,2,0,0,0,0,0,0,0,0
2019,133876,2000,Block 2000,20,33.7286996,-84.3996094,20,9,11,9,0,9,0,0,0,0,0
2020,133877,2001,Block 2001,17,33.7287036,-84.400401,17,11,6,11,1,10,0,0,0,0,0
2021,133878,2002,Block 2002,17,33.728705,-84.4012069,17,9,8,9,0,8,0,0,0,0,1
2022,133879,2003,Block 2003,10,33.7287052,-84.4020121,10,5,5,5,0,5,0,0,0,0,0
2023,133880,2004,Block 2004,18,33.7287084,-84.4027934,18,8,10,8,0,7,0,0,0,0,1
2024,133881,2005,Block 2005,23,33.7274991,-84.4024039,23,15,8,15,0,15,0,0,0,0,0
2025,133882,2006,Block 2006,20,33.7274948,-84.4012138,20,12,8,12,0,12,0,0,0,0,0
2026,133883,2007,Block 2007,15,33.7274935,-84.4004064,15,8,7,8,0,8,0,0,0,0,0
2027,133884,2008,Block 2008,20,33.7274941,-84.3996159,20,14,6,14,1,13,0,0,0,0,0
2028,133885,2009,Block 2009,20,33.7262846,-84.3996242,20,12,8,12,0,12,0,0,0,0,0
2029,133886,2010,Block 2010,16,33.7262865,-84.4004117,16,9,7,9,0,9,0,0,0,0,0
2030,133887,2011,Block 2011,10,33.7262892,-84.4012186,10,4,6,4,0,4,0,0,0,0,0
2031,133888,2012,Block 2012,20,33.7262904,-84.4020213,20,14,6,14,1,13,0,0,0,0,0
2032,133889,2013,Block 2013,14,33.7262949,-84.4027973,14,7,7,7,1,6,0,0,0,0,0
2033,133890,2014,Block 2014,19,33.7262832,-84.3988243,19,8,11,8,0,8,0,0,0,0,0
2034,133891,2015,Block 2015,15,33.7275079,-84.4035866,15,10,5,10,0,10,0,0,0,0,0
2035,133892,2016,Block 2016,14,33.7275132,-84.4044111,14,10,4,10,0,10,0,0,0,0,0
2036,133893,2017,Block 2017,9,33.7269321,-84.406385,9,8,1,8,6,2,0,0,0,0,0
2037,133894,2018,Block 2018,12,33.7263089,-84.4044073,12,8,4,8,0,8,0,0,0,0,0
2038,133897,1000,Block 1000,2,33.7235649,-84.3719475,2,1,1,1,0,1,0,0,0,0,0
2039,133899,1002,Block 1002,38,33.7210541,-84.3776627,38,25,13,25,3,20,0,1,0,1,0
2040,133900,1003,Block 1003,124,33.718608,-84.3736458,124,93,31,93,16,60,0,2,0,9,6
2041,133901,1004,Block 1004,4,33.7205321,-84.3758546,4,3,1,3,2,1,0,0,0,0,0
2042,133902,1005,Block 1005,92,33.7204241,-84.3694099,92,61,31,61,3,54,0,0,0,3,1
2043,133903,1006,Block 1006,58,33.7191414,-84.3700511,58,45,13,45,0,41,0,0,1,2,1
2044,133904,1007,Block 1007,62,33.7172907,-84.3693111,62,56,6,56,3,46,1,0,0,5,1
2045,133905,1008,Block 1008,44,33.7169477,-84.3711846,44,39,5,39,5,28,0,0,0,5,1
2046,133906,1009,Block 1009,28,33.7157069,-84.3711875,28,22,6,22,5,12,0,0,0,5,0
2047,133907,1010,Block 1010,19,33.715703,-84.369298,19,13,6,13,6,5,0,0,0,1,1
2048,133908,1011,Block 1011,8,33.71446,-84.3693143,8,4,4,4,0,4,0,0,0,0,0
2049,133909,1012,Block 1012,11,33.7144638,-84.3712035,11,8,3,8,1,2,0,0,0,5,0
2050,133910,1013,Block 1013,23,33.7180595,-84.3779211,23,23,0,23,4,18,0,0,0,0,1
2051,133911,1014,Block 1014,20,33.7195561,-84.3777135,20,14,6,14,1,12,0,0,0,0,1
2052,133912,1015,Block 1015,19,33.7160902,-84.3757581,19,15,4,15,0,13,0,0,0,2,0
2053,133914,1017,Block 1017,13,33.7168712,-84.3769654,13,8,5,8,3,4,0,0,0,1,0
2054,133918,1001,Block 1001,46,33.7188727,-84.40116,46,40,6,40,4,34,0,0,0,0,2
2055,133919,1002,Block 1002,31,33.7191889,-84.4041792,31,27,4,27,2,24,0,0,0,0,1
2056,133920,1003,Block 1003,9,33.7188106,-84.4068004,9,9,0,9,5,4,0,0,0,0,0
2057,133921,1004,Block 1004,39,33.7182254,-84.4041012,39,32,7,32,7,25,0,0,0,0,0
2058,133922,1005,Block 1005,29,33.717261,-84.40266,29,27,2,27,6,21,0,0,0,0,0
2059,133923,1006,Block 1006,25,33.7159796,-84.4001939,25,21,4,21,2,18,1,0,0,0,0
2060,133924,1007,Block 1007,22,33.7162895,-84.4028595,22,19,3,19,4,14,0,0,0,0,1
2061,133925,1008,Block 1008,38,33.7165186,-84.4060082,38,33,5,33,4,29,0,0,0,0,0
2062,133926,1009,Block 1009,10,33.7176951,-84.4068107,10,9,1,9,1,8,0,0,0,0,0
2063,133929,1012,Block 1012,40,33.7113356,-84.4047814,40,33,7,33,6,25,0,2,0,0,0
2064,133930,1013,Block 1013,27,33.715242,-84.4012926,27,25,2,25,5,19,0,0,0,0,1
2065,133931,1014,Block 1014,19,33.7172768,-84.4049119,19,17,2,17,4,13,0,0,0,0,0
2066,133933,2000,Block 2000,38,33.712366,-84.408443,38,31,7,31,0,31,0,0,0,0,0
2067,133934,2001,Block 2001,39,33.7123722,-84.4094441,39,34,5,34,4,30,0,0,0,0,0
2068,133935,2002,Block 2002,37,33.7123759,-84.41044,37,29,8,29,3,25,0,0,0,1,0
2069,133936,2003,Block 2003,1,33.7120092,-84.4129447,1,1,0,1,0,1,0,0,0,0,0
2070,133937,2004,Block 2004,31,33.7135222,-84.4162272,31,28,3,28,1,26,0,0,0,1,0
2071,133938,2005,Block 2005,24,33.7119888,-84.4175999,24,18,6,18,5,11,0,0,0,0,2
2072,133939,2006,Block 2006,58,33.7105315,-84.4150815,58,54,4,54,11,42,0,0,0,0,1
2073,133940,2007,Block 2007,38,33.708566,-84.4096481,38,33,5,33,0,33,0,0,0,0,0
2074,133941,2008,Block 2008,40,33.7073964,-84.4143375,40,34,6,34,6,28,0,0,0,0,0
2075,133942,2009,Block 2009,23,33.7090823,-84.4162674,23,20,3,20,2,18,0,0,0,0,0
2076,133943,2010,Block 2010,17,33.7087499,-84.4175027,17,14,3,14,1,12,0,0,0,0,1
2077,133944,2011,Block 2011,31,33.7078725,-84.4130213,31,24,7,24,2,22,0,0,0,0,0
2078,133945,2012,Block 2012,46,33.7074373,-84.4117386,46,31,15,31,0,31,0,0,0,0,0
2079,133946,2013,Block 2013,22,33.7060103,-84.4101879,22,17,5,17,1,16,0,0,0,0,0
2080,133947,2014,Block 2014,32,33.7037979,-84.4127027,32,29,3,29,5,24,0,0,0,0,0
2081,133948,2015,Block 2015,29,33.7046349,-84.4141474,29,23,6,23,3,20,0,0,0,0,0
2082,133949,2016,Block 2016,30,33.7067195,-84.4158363,30,27,3,27,3,24,0,0,0,0,0
2083,133950,2017,Block 2017,10,33.7066595,-84.4174865,10,9,1,9,2,7,0,0,0,0,0
2084,133951,2018,Block 2018,19,33.7054574,-84.4166089,19,19,0,19,4,15,0,0,0,0,0
2085,133952,2019,Block 2019,21,33.703873,-84.4153795,21,16,5,16,5,10,0,0,0,0,1
2086,133953,2020,Block 2020,24,33.7038392,-84.4165173,24,20,4,20,1,19,0,0,0,0,0
2087,133954,2021,Block 2021,25,33.7038549,-84.4176663,25,20,5,20,2,17,0,0,0,1,0
2088,133957,3001,Block 3001,1,33.7239585,-84.4145639,1,1,0,1,0,1,0,0,0,0,0
2089,133960,3004,Block 3004,11,33.721708,-84.4157938,11,10,1,10,0,10,0,0,0,0,0
2090,133961,3005,Block 3005,26,33.7216551,-84.4138824,26,18,8,18,5,12,1,0,0,0,0
2091,133962,3006,Block 3006,30,33.7203537,-84.4107682,30,25,5,25,5,20,0,0,0,0,0
2092,133964,3008,Block 3008,5,33.7188965,-84.4085491,5,5,0,5,0,4,0,0,0,1,0
2093,133965,3009,Block 3009,22,33.7189003,-84.4103087,22,17,5,17,2,14,0,1,0,0,0
2094,133966,3010,Block 3010,16,33.7189065,-84.4121147,16,13,3,13,0,13,0,0,0,0,0
2095,133967,3011,Block 3011,49,33.7197589,-84.4148499,49,39,10,39,6,33,0,0,0,0,0
2096,133968,3012,Block 3012,15,33.7207498,-84.4174514,15,13,2,13,2,10,0,0,0,0,1
2097,133969,3013,Block 3013,42,33.720719,-84.4148535,42,31,11,31,5,25,0,0,0,0,1
2098,133970,3014,Block 3014,3,33.7188037,-84.4174789,3,0,3,0,0,0,0,0,0,0,0
2099,133971,3015,Block 3015,18,33.7187966,-84.4160896,18,13,5,13,3,10,0,0,0,0,0
2100,133972,3016,Block 3016,21,33.7187782,-84.4140788,21,17,4,17,6,11,0,0,0,0,0
2101,133974,4000,Block 4000,8,33.7172399,-84.4083771,8,7,1,7,4,3,0,0,0,0,0
2102,133975,4001,Block 4001,23,33.7172441,-84.4093869,23,20,3,20,2,17,0,0,0,1,0
2103,133976,4002,Block 4002,26,33.7172487,-84.4103758,26,20,6,20,4,16,0,0,0,0,0
2104,133977,4003,Block 4003,20,33.7172505,-84.4113619,20,20,0,20,3,15,0,0,0,1,1
2105,133978,4004,Block 4004,21,33.7172556,-84.4123573,21,16,5,16,2,12,0,1,0,1,0
2106,133979,4005,Block 4005,21,33.7172568,-84.4134563,21,19,2,19,4,12,0,0,0,1,2
2107,133980,4006,Block 4006,29,33.7172644,-84.4145601,29,20,9,20,8,12,0,0,0,0,0
2108,133981,4007,Block 4007,31,33.7172673,-84.4155778,31,25,6,25,11,13,0,1,0,0,0
2109,133982,4008,Block 4008,28,33.7172709,-84.4165965,28,23,5,23,5,18,0,0,0,0,0
2110,133983,4009,Block 4009,21,33.717271,-84.4176018,21,17,4,17,4,13,0,0,0,0,0
2111,133984,4010,Block 4010,26,33.7152948,-84.4176237,26,23,3,23,4,19,0,0,0,0,0
2112,133985,4011,Block 4011,27,33.7152932,-84.4166112,27,19,8,19,9,10,0,0,0,0,0
2113,133986,4012,Block 4012,27,33.7152861,-84.4155947,27,25,2,25,10,15,0,0,0,0,0
2114,133987,4013,Block 4013,21,33.7152823,-84.4145786,21,19,2,19,3,16,0,0,0,0,0
2115,133988,4014,Block 4014,22,33.7152793,-84.4134789,22,20,2,20,6,12,0,0,1,0,1
2116,133989,4015,Block 4015,18,33.7152723,-84.4123846,18,15,3,15,5,9,0,0,0,1,0
2117,133990,4016,Block 4016,27,33.7152707,-84.411392,27,20,7,20,5,14,0,0,0,0,1
2118,133991,4017,Block 4017,24,33.7152667,-84.4104061,24,20,4,20,2,17,0,0,0,0,1
2119,133992,4018,Block 4018,20,33.7152637,-84.4094179,20,15,5,15,4,11,0,0,0,0,0
2120,133993,4019,Block 4019,25,33.7152582,-84.4084082,25,16,9,16,7,9,0,0,0,0,0
2121,133999,1003,Block 1003,1,33.7232625,-84.4197003,1,1,0,1,0,1,0,0,0,0,0
2122,134004,1008,Block 1008,7,33.7176516,-84.4233149,7,6,1,6,0,5,0,0,0,0,1
2123,134005,1009,Block 1009,48,33.7201786,-84.4208205,48,41,7,41,6,34,0,1,0,0,0
2124,134006,1010,Block 1010,53,33.7176781,-84.4201466,53,37,16,37,2,35,0,0,0,0,0
2125,134007,1011,Block 1011,37,33.7154703,-84.4215891,37,30,7,30,9,20,0,1,0,0,0
2126,134009,1013,Block 1013,55,33.7133359,-84.4204583,55,45,10,45,9,36,0,0,0,0,0
2127,134010,1014,Block 1014,47,33.7123442,-84.4202826,47,35,12,35,7,28,0,0,0,0,0
2128,134011,1015,Block 1015,59,33.7120803,-84.4228914,59,47,12,47,11,34,0,0,0,1,1
2129,134012,1016,Block 1016,16,33.7139141,-84.4251517,16,8,8,8,0,8,0,0,0,0,0
2130,134013,1017,Block 1017,31,33.7129711,-84.4249606,31,14,17,14,2,12,0,0,0,0,0
2131,134014,1018,Block 1018,12,33.7115017,-84.4242253,12,6,6,6,4,2,0,0,0,0,0
2132,134015,1019,Block 1019,46,33.7113786,-84.4201642,46,36,10,36,7,29,0,0,0,0,0
2133,134017,2000,Block 2000,40,33.7103983,-84.4199088,40,35,5,35,14,19,0,0,0,1,1
2134,134018,2001,Block 2001,28,33.7093147,-84.4220606,28,24,4,24,6,18,0,0,0,0,0
2135,134019,2002,Block 2002,19,33.7090195,-84.4232881,19,15,4,15,5,9,0,0,0,1,0
2136,134020,2003,Block 2003,15,33.7093072,-84.4258967,15,8,7,8,2,6,0,0,0,0,0
2137,134022,2005,Block 2005,34,33.7076274,-84.424376,34,23,11,23,7,16,0,0,0,0,0
2138,134023,2006,Block 2006,20,33.7074566,-84.4226436,20,17,3,17,2,14,0,0,0,0,1
2139,134024,2007,Block 2007,15,33.7078222,-84.4214171,15,12,3,12,3,9,0,0,0,0,0
2140,134025,2008,Block 2008,37,33.7083768,-84.4195193,37,27,10,27,9,17,0,0,0,0,1
2141,134026,2009,Block 2009,31,33.7094535,-84.4198029,31,29,2,29,7,22,0,0,0,0,0
2142,134028,2011,Block 2011,27,33.7061351,-84.4218804,27,19,8,19,4,15,0,0,0,0,0
2143,134029,2012,Block 2012,30,33.7059263,-84.4198788,30,22,8,22,7,15,0,0,0,0,0
2144,134030,2013,Block 2013,24,33.7072946,-84.4192595,24,21,3,21,3,17,1,0,0,0,0
2145,134031,2014,Block 2014,19,33.7064136,-84.4190677,19,18,1,18,8,10,0,0,0,0,0
2146,134036,2019,Block 2019,19,33.7060372,-84.4241814,19,15,4,15,6,9,0,0,0,0,0
2147,134037,2020,Block 2020,34,33.7049241,-84.4251083,34,30,4,30,3,26,0,0,0,1,0
2148,134038,2021,Block 2021,51,33.7029739,-84.4246381,51,40,11,40,4,34,0,0,0,1,1
2149,134039,2022,Block 2022,44,33.7033856,-84.421236,44,36,8,36,2,32,0,1,0,0,1
2150,134040,2023,Block 2023,48,33.7033849,-84.4197224,48,40,8,40,6,31,0,1,0,2,0
2151,134041,2024,Block 2024,17,33.7040997,-84.4188195,17,16,1,16,8,8,0,0,0,0,0
2152,134042,2025,Block 2025,5,33.7019045,-84.4271211,5,5,0,5,2,3,0,0,0,0,0
2153,134048,1000,Block 1000,44,33.7210939,-84.4245531,44,39,5,39,0,35,0,0,1,0,3
2154,134049,1001,Block 1001,142,33.7209119,-84.4264266,142,102,40,102,3,94,0,0,0,3,2
2155,134050,1002,Block 1002,48,33.7216983,-84.4291299,48,22,26,22,3,19,0,0,0,0,0
2156,134051,1003,Block 1003,112,33.7190546,-84.4318179,112,81,31,81,2,76,1,0,0,0,2
2157,134052,1004,Block 1004,24,33.717188,-84.431227,24,10,14,10,0,9,0,0,0,0,1
2158,134053,1005,Block 1005,81,33.7190702,-84.4292648,81,55,26,55,1,53,0,0,0,1,0
2159,134054,1006,Block 1006,18,33.7173185,-84.4294143,18,10,8,10,0,10,0,0,0,0,0
2160,134055,1007,Block 1007,15,33.7152696,-84.4307904,15,8,7,8,1,7,0,0,0,0,0
2161,134056,1008,Block 1008,12,33.7154768,-84.4298866,12,6,6,6,1,5,0,0,0,0,0
2162,134057,1009,Block 1009,40,33.7158734,-84.4284282,40,25,15,25,0,24,0,0,0,0,1
2163,134059,1011,Block 1011,10,33.7187895,-84.4263184,10,6,4,6,0,6,0,0,0,0,0
2164,134060,1012,Block 1012,5,33.7189928,-84.425428,5,2,3,2,0,2,0,0,0,0,0
2165,134064,1016,Block 1016,1,33.7148694,-84.4266616,1,1,0,1,0,1,0,0,0,0,0
2166,134067,1019,Block 1019,10,33.7149294,-84.4321555,10,4,6,4,0,4,0,0,0,0,0
2167,134068,1020,Block 1020,12,33.718642,-84.4270958,12,9,3,9,0,9,0,0,0,0,0
2168,134071,1000,Block 1000,28,33.7117989,-84.3777631,28,10,18,10,1,9,0,0,0,0,0
2169,134072,1001,Block 1001,9,33.7099277,-84.3777089,9,8,1,8,0,8,0,0,0,0,0
2170,134073,1002,Block 1002,20,33.7096987,-84.3786955,20,8,12,8,0,8,0,0,0,0,0
2171,134074,1003,Block 1003,10,33.7143512,-84.3800908,10,10,0,10,0,9,0,0,0,0,1
2172,134077,1006,Block 1006,9,33.7128038,-84.3830482,9,8,1,8,0,8,0,0,0,0,0
2173,134078,1007,Block 1007,26,33.7124598,-84.3847841,26,15,11,15,0,15,0,0,0,0,0
2174,134079,1008,Block 1008,9,33.712327,-84.3865895,9,6,3,6,0,5,0,0,0,0,1
2175,134080,1009,Block 1009,6,33.7123289,-84.3876948,6,4,2,4,0,4,0,0,0,0,0
2176,134081,1010,Block 1010,5,33.7115345,-84.3877055,5,3,2,3,0,3,0,0,0,0,0
2177,134082,1011,Block 1011,11,33.7115314,-84.3866008,11,6,5,6,0,6,0,0,0,0,0
2178,134083,1012,Block 1012,11,33.7115472,-84.3853598,11,6,5,6,0,6,0,0,0,0,0
2179,134084,1013,Block 1013,6,33.7117881,-84.3839896,6,5,1,5,0,5,0,0,0,0,0
2180,134086,1015,Block 1015,78,33.7111498,-84.3825273,78,77,1,77,1,75,0,0,0,1,0
2181,134087,1016,Block 1016,9,33.7112983,-84.3811029,9,6,3,6,0,5,0,0,0,0,1
2182,134088,1017,Block 1017,5,33.71249,-84.381176,5,4,1,4,0,4,0,0,0,0,0
2183,134089,1018,Block 1018,13,33.7103247,-84.3808189,13,7,6,7,0,6,0,0,0,0,1
2184,134090,1019,Block 1019,6,33.7102737,-84.3821467,6,4,2,4,0,3,0,0,0,1,0
2185,134091,1020,Block 1020,6,33.7102178,-84.3831178,6,3,3,3,0,3,0,0,0,0,0
2186,134092,1021,Block 1021,11,33.7109802,-84.3837616,11,7,4,7,1,6,0,0,0,0,0
2187,134093,1022,Block 1022,23,33.709183,-84.3819796,23,19,4,19,1,18,0,0,0,0,0
2188,134094,1023,Block 1023,84,33.708453,-84.385415,84,59,25,59,9,47,1,0,0,0,2
2189,134095,1024,Block 1024,15,33.7090012,-84.3841686,15,11,4,11,1,10,0,0,0,0,0
2190,134096,1025,Block 1025,11,33.7098807,-84.3841183,11,8,3,8,1,7,0,0,0,0,0
2191,134097,1026,Block 1026,6,33.7091893,-84.3831447,6,2,4,2,0,2,0,0,0,0,0
2192,134098,1027,Block 1027,11,33.7089266,-84.380416,11,9,2,9,0,8,1,0,0,0,0
2193,134099,1028,Block 1028,17,33.7088428,-84.3794386,17,14,3,14,1,12,1,0,0,0,0
2194,134100,1029,Block 1029,16,33.7067579,-84.3827191,16,7,9,7,2,5,0,0,0,0,0
2195,134101,1030,Block 1030,12,33.7067562,-84.3810826,12,7,5,7,1,5,0,0,0,0,1
2196,134103,1032,Block 1032,4,33.7073751,-84.3794499,4,4,0,4,0,4,0,0,0,0,0
2197,134104,1033,Block 1033,12,33.7079569,-84.3786375,12,2,10,2,0,2,0,0,0,0,0
2198,134105,1034,Block 1034,17,33.7080385,-84.3773431,17,8,9,8,0,8,0,0,0,0,0
2199,134106,1035,Block 1035,24,33.7073348,-84.3760258,24,14,10,14,1,10,0,0,0,0,3
2200,134107,1036,Block 1036,13,33.7067079,-84.3771666,13,5,8,5,0,5,0,0,0,0,0
2201,134108,1037,Block 1037,6,33.7073007,-84.3778503,6,1,5,1,0,1,0,0,0,0,0
2202,134109,1038,Block 1038,7,33.7065646,-84.3787904,7,1,6,1,0,1,0,0,0,0,0
2203,134110,1039,Block 1039,14,33.7058653,-84.3782245,14,9,5,9,1,8,0,0,0,0,0
2204,134111,1040,Block 1040,5,33.7052543,-84.3789307,5,0,5,0,0,0,0,0,0,0,0
2205,134112,1041,Block 1041,2,33.7056234,-84.3796743,2,2,0,2,1,1,0,0,0,0,0
2206,134116,2002,Block 2002,105,33.7149961,-84.3948467,105,100,5,100,2,98,0,0,0,0,0
2207,134117,2003,Block 2003,400,33.708804,-84.3960048,400,337,63,337,10,310,0,2,0,13,2
2208,134119,2005,Block 2005,9,33.711404,-84.3998918,9,7,2,7,0,7,0,0,0,0,0
2209,134120,2006,Block 2006,13,33.7105702,-84.4001108,13,13,0,13,0,12,0,1,0,0,0
2210,134121,2007,Block 2007,35,33.7123778,-84.3988058,35,26,9,26,0,26,0,0,0,0,0
2211,134122,2008,Block 2008,1,33.718046,-84.3944791,1,1,0,1,0,1,0,0,0,0,0
2212,134123,2009,Block 2009,18,33.7100902,-84.39703,18,12,6,12,2,10,0,0,0,0,0
2213,134125,2011,Block 2011,21,33.7172422,-84.3959983,21,21,0,21,3,18,0,0,0,0,0
2214,134126,2012,Block 2012,8,33.7169346,-84.3947091,8,7,1,7,1,6,0,0,0,0,0
2215,134129,2015,Block 2015,27,33.7111283,-84.3985262,27,23,4,23,1,22,0,0,0,0,0
2216,134130,2016,Block 2016,15,33.711428,-84.3969962,15,11,4,11,1,10,0,0,0,0,0
2217,134131,2017,Block 2017,16,33.7107967,-84.3970104,16,13,3,13,0,13,0,0,0,0,0
2218,134132,2018,Block 2018,78,33.7129483,-84.3956164,78,63,15,63,4,58,0,0,0,1,0
2219,134133,2019,Block 2019,10,33.7040745,-84.4018696,10,5,5,5,1,4,0,0,0,0,0
2220,134135,3000,Block 3000,12,33.7056358,-84.3811364,12,10,2,10,0,9,0,0,0,0,1
2221,134136,3001,Block 3001,11,33.7056362,-84.3827299,11,8,3,8,3,5,0,0,0,0,0
2222,134137,3002,Block 3002,15,33.7056474,-84.3841438,15,12,3,12,1,10,0,0,0,0,1
2223,134138,3003,Block 3003,12,33.7056585,-84.3856246,12,10,2,10,2,6,0,1,0,0,1
2224,134139,3004,Block 3004,18,33.7056754,-84.387239,18,16,2,16,3,13,0,0,0,0,0
2225,134140,3005,Block 3005,8,33.7016525,-84.3957753,8,6,2,6,1,5,0,0,0,0,0
2226,134144,3009,Block 3009,184,33.7058758,-84.3948533,184,174,10,174,5,158,2,2,0,1,6
2227,134145,3010,Block 3010,35,33.7064875,-84.3977624,35,31,4,31,0,28,0,2,0,0,1
2228,134146,3011,Block 3011,2,33.7077952,-84.3940913,2,0,2,0,0,0,0,0,0,0,0
2229,134147,3012,Block 3012,7,33.705937,-84.3979827,7,7,0,7,0,7,0,0,0,0,0
2230,134149,3014,Block 3014,4,33.7055455,-84.396106,4,4,0,4,0,4,0,0,0,0,0
2231,134150,3015,Block 3015,60,33.7067985,-84.3962642,60,55,5,55,0,51,0,0,0,1,3
2232,134152,3017,Block 3017,19,33.7055555,-84.3951757,19,16,3,16,0,15,0,0,0,0,1
2233,134153,3018,Block 3018,46,33.7064103,-84.3995162,46,16,30,16,1,15,0,0,0,0,0
2234,134154,3019,Block 3019,49,33.7083268,-84.400503,49,42,7,42,0,41,0,0,0,0,1
2235,134155,3020,Block 3020,23,33.7069846,-84.4011185,23,23,0,23,1,22,0,0,0,0,0
2236,134156,3021,Block 3021,7,33.7034234,-84.3857985,7,6,1,6,0,6,0,0,0,0,0
2237,134157,3022,Block 3022,43,33.704334,-84.3830534,43,26,17,26,12,13,0,0,0,0,1
2238,134158,3023,Block 3023,7,33.7031536,-84.384619,7,3,4,3,2,1,0,0,0,0,0
2239,134159,3024,Block 3024,2,33.7017094,-84.4005251,2,1,1,1,0,0,0,0,0,0,1
2240,134163,3028,Block 3028,24,33.7000454,-84.4018389,24,16,8,16,3,12,0,0,0,0,1
2241,134164,3029,Block 3029,14,33.6989967,-84.3999746,14,10,4,10,4,6,0,0,0,0,0
2242,134166,3031,Block 3031,22,33.6997611,-84.3963901,22,17,5,17,7,8,0,0,0,0,2
2243,134167,3032,Block 3032,19,33.698773,-84.3958214,19,13,6,13,6,7,0,0,0,0,0
2244,134171,1000,Block 1000,18,33.7102925,-84.3677886,18,8,10,8,1,7,0,0,0,0,0
2245,134174,1000,Block 1000,203,33.7078722,-84.3613693,203,200,3,200,1,195,1,0,0,1,2
2246,134176,1002,Block 1002,11,33.706017,-84.3648948,11,10,1,10,0,10,0,0,0,0,0
2247,134177,1003,Block 1003,15,33.7002599,-84.3603452,15,14,1,14,0,13,0,0,1,0,0
2248,134178,1004,Block 1004,259,33.7038797,-84.360632,259,246,13,246,1,239,3,1,0,0,2
2249,134180,1006,Block 1006,37,33.7007699,-84.3590846,37,34,3,34,0,34,0,0,0,0,0
2250,134183,1000,Block 1000,23,33.7229567,-84.3501769,23,21,2,21,10,9,1,1,0,0,0
2251,134184,1001,Block 1001,27,33.7241459,-84.3522309,27,24,3,24,19,2,1,0,0,0,2
2252,134185,1002,Block 1002,20,33.7226377,-84.3516037,20,18,2,18,14,4,0,0,0,0,0
2253,134186,1003,Block 1003,26,33.7228764,-84.3529326,26,22,4,22,19,3,0,0,0,0,0
2254,134187,1004,Block 1004,26,33.7211943,-84.3522365,26,21,5,21,17,3,0,0,0,0,1
2255,134188,1005,Block 1005,19,33.7193131,-84.3509847,19,19,0,19,12,7,0,0,0,0,0
2256,134189,1006,Block 1006,24,33.7197754,-84.3529589,24,21,3,21,18,2,0,1,0,0,0
2257,134190,1007,Block 1007,14,33.7197616,-84.3516835,14,11,3,11,6,4,0,0,0,1,0
2258,134191,1008,Block 1008,22,33.7166539,-84.3516885,22,20,2,20,4,16,0,0,0,0,0
2259,134192,1009,Block 1009,33,33.7123489,-84.3510428,33,30,3,30,5,21,0,0,1,3,0
2260,134193,1010,Block 1010,18,33.7131403,-84.3521574,18,16,2,16,5,10,0,0,0,0,1
2261,134194,1011,Block 1011,41,33.7132273,-84.3543048,41,33,8,33,9,23,1,0,0,0,0
2262,134195,1012,Block 1012,25,33.7107398,-84.3551582,25,19,6,19,5,10,0,0,0,3,1
2263,134197,2000,Block 2000,19,33.7164491,-84.357534,19,14,5,14,11,3,0,0,0,0,0
2264,134198,2001,Block 2001,186,33.71417,-84.3593678,186,144,42,144,46,73,0,2,0,19,4
2265,134200,2003,Block 2003,45,33.7155385,-84.3635164,45,39,6,39,23,13,0,1,0,1,1
2266,134201,2004,Block 2004,2,33.7143211,-84.3633423,2,2,0,2,0,1,0,0,0,0,1
2267,134202,2005,Block 2005,13,33.7164771,-84.366001,13,10,3,10,5,4,0,0,0,1,0
2268,134203,2006,Block 2006,6,33.7164862,-84.3676154,6,6,0,6,1,5,0,0,0,0,0
2269,134204,2007,Block 2007,19,33.7152309,-84.3676111,19,16,3,16,5,7,0,0,0,4,0
2270,134205,2008,Block 2008,21,33.7149966,-84.3659971,21,19,2,19,8,8,0,0,0,3,0
2271,134206,2009,Block 2009,6,33.7135622,-84.3660401,6,6,0,6,4,1,0,0,0,1,0
2272,134207,2010,Block 2010,7,33.7140484,-84.3675805,7,4,3,4,0,4,0,0,0,0,0
2273,134208,2011,Block 2011,13,33.7129801,-84.3647537,13,9,4,9,7,2,0,0,0,0,0
2274,134209,2012,Block 2012,48,33.7126616,-84.362674,48,43,5,43,24,15,0,1,0,1,2
2275,134210,2013,Block 2013,5,33.7102927,-84.3597105,5,3,2,3,0,2,0,0,0,0,1
2276,134211,2014,Block 2014,176,33.7110151,-84.3575511,176,128,48,128,14,95,0,0,0,14,5
2277,134212,2015,Block 2015,25,33.7113675,-84.35649,25,22,3,22,4,13,0,0,0,5,0
2278,134214,3000,Block 3000,162,33.7229894,-84.3587863,162,129,33,129,37,85,0,2,0,4,1
2279,134217,3003,Block 3003,14,33.7249917,-84.3631849,14,13,1,13,12,1,0,0,0,0,0
2280,134218,3004,Block 3004,18,33.7265505,-84.3628557,18,17,1,17,14,3,0,0,0,0,0
2281,134219,3005,Block 3005,14,33.7266067,-84.3652899,14,13,1,13,5,5,1,0,0,2,0
2282,134220,3006,Block 3006,14,33.7211044,-84.3632334,14,13,1,13,7,6,0,0,0,0,0
2283,134221,3007,Block 3007,116,33.7199582,-84.364682,116,107,9,107,63,31,1,2,0,9,1
2284,134222,3008,Block 3008,18,33.7226801,-84.3648701,18,14,4,14,10,3,1,0,0,0,0
2285,134223,3009,Block 3009,38,33.724028,-84.3678601,38,35,3,35,12,21,0,0,0,0,2
2286,134224,3010,Block 3010,40,33.7252256,-84.3678436,40,29,11,29,10,17,0,2,0,0,0
2287,134225,3011,Block 3011,11,33.7253808,-84.3663656,11,9,2,9,7,0,0,0,0,1,1
2288,134226,3012,Block 3012,15,33.7253592,-84.364588,15,15,0,15,13,2,0,0,0,0,0
2289,134227,3013,Block 3013,16,33.7245676,-84.3645997,16,10,6,10,8,1,0,0,0,1,0
2290,134228,3014,Block 3014,16,33.7245832,-84.3663735,16,15,1,15,11,3,0,0,0,1,0
2291,134229,3015,Block 3015,7,33.7237921,-84.3668684,7,7,0,7,4,3,0,0,0,0,0
2292,134230,3016,Block 3016,11,33.7237841,-84.3659792,11,10,1,10,7,2,0,0,0,1,0
2293,134231,3017,Block 3017,13,33.7237635,-84.3646054,13,9,4,9,6,2,0,0,0,1,0
2294,134232,3018,Block 3018,15,33.7184586,-84.3676361,15,14,1,14,6,6,0,0,0,2,0
2295,134233,3019,Block 3019,26,33.7184463,-84.358729,26,22,4,22,7,13,0,0,0,2,0
2296,134234,3020,Block 3020,3,33.7176879,-84.3577429,3,2,1,2,0,2,0,0,0,0,0
2297,134235,3021,Block 3021,54,33.7218649,-84.3540609,54,47,7,47,36,8,0,0,0,3,0
2298,134241,1003,Block 1003,32,33.6969777,-84.3934788,32,24,8,24,7,14,0,0,0,2,1
2299,134243,1005,Block 1005,6,33.6965831,-84.3979085,6,4,2,4,1,3,0,0,0,0,0
2300,134244,1006,Block 1006,10,33.6974916,-84.3970332,10,4,6,4,0,3,0,0,0,1,0
2301,134245,1007,Block 1007,139,33.6926828,-84.3978546,139,112,27,112,10,98,0,0,0,3,1
2302,134246,1008,Block 1008,16,33.6914018,-84.3988202,16,9,7,9,2,5,0,0,0,2,0
2303,134247,1009,Block 1009,35,33.694325,-84.3941223,35,30,5,30,0,29,0,0,0,0,1
2304,134248,1010,Block 1010,25,33.691427,-84.3954814,25,22,3,22,1,21,0,0,0,0,0
2305,134249,1011,Block 1011,52,33.693728,-84.3999113,52,32,20,32,7,24,0,0,0,0,1
2306,134250,1012,Block 1012,15,33.6948065,-84.3979702,15,8,7,8,1,7,0,0,0,0,0
2307,134251,1013,Block 1013,25,33.6906184,-84.3916436,25,20,5,20,3,17,0,0,0,0,0
2308,134252,1014,Block 1014,10,33.6895636,-84.3937241,10,10,0,10,1,9,0,0,0,0,0
2309,134253,1015,Block 1015,31,33.6941534,-84.3953418,31,29,2,29,1,27,0,0,0,1,0
2310,134262,1024,Block 1024,334,33.6851319,-84.3950441,334,233,101,233,6,223,0,2,0,0,2
2311,134263,1025,Block 1025,21,33.6863082,-84.3904427,21,16,5,16,1,15,0,0,0,0,0
2312,134264,1026,Block 1026,99,33.6830076,-84.3911892,99,66,33,66,3,62,1,0,0,0,0
2313,134265,1027,Block 1027,17,33.6952761,-84.3987593,17,13,4,13,0,13,0,0,0,0,0
2314,134267,1029,Block 1029,28,33.6957005,-84.3907828,28,21,7,21,3,17,0,0,0,1,0
2315,134271,2000,Block 2000,37,33.6881832,-84.3803468,37,28,9,28,1,25,0,0,0,2,0
2316,134272,2001,Block 2001,22,33.6877584,-84.3821811,22,18,4,18,0,18,0,0,0,0,0
2317,134273,2002,Block 2002,46,33.6863013,-84.3808217,46,41,5,41,4,37,0,0,0,0,0
2318,134274,2003,Block 2003,8,33.686934,-84.3830204,8,8,0,8,0,8,0,0,0,0,0
2319,134275,2004,Block 2004,105,33.6849695,-84.3855967,105,99,6,99,9,87,0,0,0,1,2
2320,134276,2005,Block 2005,8,33.68395,-84.3852973,8,8,0,8,0,8,0,0,0,0,0
2321,134277,2006,Block 2006,26,33.6828358,-84.3881485,26,23,3,23,1,22,0,0,0,0,0
2322,134278,2007,Block 2007,30,33.6878814,-84.3890735,30,28,2,28,2,26,0,0,0,0,0
2323,134279,2008,Block 2008,24,33.6884713,-84.3865874,24,23,1,23,2,21,0,0,0,0,0
2324,134280,2009,Block 2009,10,33.6860103,-84.3830216,10,9,1,9,0,8,0,0,0,0,1
2325,134281,2010,Block 2010,17,33.6848092,-84.3805482,17,13,4,13,0,12,0,0,0,1,0
2326,134283,3000,Block 3000,52,33.6990647,-84.3820871,52,45,7,45,11,33,0,0,0,0,1
2327,134284,3001,Block 3001,11,33.6992273,-84.3864117,11,6,5,6,1,5,0,0,0,0,0
2328,134285,3002,Block 3002,36,33.6958113,-84.3892695,36,27,9,27,1,26,0,0,0,0,0
2329,134286,3003,Block 3003,19,33.6957086,-84.3864233,19,13,6,13,2,11,0,0,0,0,0
2330,134287,3004,Block 3004,14,33.6944908,-84.3866675,14,11,3,11,0,11,0,0,0,0,0
2331,134288,3005,Block 3005,19,33.6946883,-84.3875249,19,11,8,11,0,10,0,0,0,0,1
2332,134289,3006,Block 3006,97,33.693614,-84.3817685,97,79,18,79,6,69,1,0,0,1,2
2333,134290,3007,Block 3007,93,33.692869,-84.3777958,93,80,13,80,6,73,0,0,0,1,0
2334,134291,3008,Block 3008,20,33.6951171,-84.3752432,20,17,3,17,0,17,0,0,0,0,0
2335,134292,3009,Block 3009,22,33.6942137,-84.3752601,22,18,4,18,2,16,0,0,0,0,0
2336,134293,3010,Block 3010,24,33.6910017,-84.375242,24,19,5,19,0,19,0,0,0,0,0
2337,134294,3011,Block 3011,72,33.6907032,-84.3860032,72,53,19,53,5,46,2,0,0,0,0
2338,134295,3012,Block 3012,29,33.6906555,-84.3876318,29,22,7,22,0,22,0,0,0,0,0
2339,134298,1000,Block 1000,50,33.6920142,-84.3680859,50,44,6,44,4,38,0,0,0,2,0
2340,134299,1001,Block 1001,33,33.6952528,-84.3717982,33,26,7,26,1,24,0,0,0,1,0
2341,134300,1002,Block 1002,33,33.6953133,-84.3731073,33,28,5,28,3,25,0,0,0,0,0
2342,134301,1003,Block 1003,52,33.6908563,-84.3728115,52,37,15,37,3,33,0,0,0,0,1
2343,134302,1004,Block 1004,28,33.69235,-84.3718695,28,27,1,27,1,26,0,0,0,0,0
2344,134303,1005,Block 1005,29,33.692339,-84.3705935,29,20,9,20,0,19,0,0,0,1,0
2345,134304,1006,Block 1006,20,33.6899218,-84.3706101,20,16,4,16,1,13,0,0,0,0,2
2346,134305,1007,Block 1007,141,33.6867547,-84.371951,141,120,21,120,12,102,0,0,0,1,5
2347,134307,2000,Block 2000,15,33.6917121,-84.3632321,15,13,2,13,0,12,0,0,0,0,1
2348,134308,2001,Block 2001,72,33.6857507,-84.3568234,72,44,28,44,1,43,0,0,0,0,0
2349,134309,2002,Block 2002,17,33.686952,-84.3563378,17,12,5,12,0,12,0,0,0,0,0
2350,134310,2003,Block 2003,10,33.6870894,-84.3551854,10,6,4,6,2,4,0,0,0,0,0
2351,134311,2004,Block 2004,13,33.6858844,-84.3540182,13,7,6,7,0,7,0,0,0,0,0
2352,134312,2005,Block 2005,20,33.6882414,-84.3585936,20,13,7,13,0,12,0,0,1,0,0
2353,134313,2006,Block 2006,27,33.6890131,-84.3583954,27,21,6,21,1,20,0,0,0,0,0
2354,134314,2007,Block 2007,15,33.6880692,-84.362146,15,12,3,12,0,12,0,0,0,0,0
2355,134315,2008,Block 2008,28,33.689317,-84.3621596,28,18,10,18,2,15,0,0,0,1,0
2356,134317,2010,Block 2010,93,33.6834711,-84.3616716,93,88,5,88,25,15,1,15,0,29,3
2357,134319,3000,Block 3000,10,33.7041527,-84.378722,10,7,3,7,0,7,0,0,0,0,0
2358,134320,3001,Block 3001,14,33.7044706,-84.3798692,14,10,4,10,0,10,0,0,0,0,0
2359,134321,3002,Block 3002,17,33.7037001,-84.3806706,17,9,8,9,0,9,0,0,0,0,0
2360,134322,3003,Block 3003,19,33.7030609,-84.3812842,19,10,9,10,0,6,0,1,0,3,0
2361,134323,3004,Block 3004,11,33.702741,-84.3828526,11,11,0,11,0,11,0,0,0,0,0
2362,134324,3005,Block 3005,43,33.7001868,-84.3808921,43,31,12,31,4,26,0,0,0,1,0
2363,134325,3006,Block 3006,26,33.7026605,-84.3793729,26,15,11,15,5,10,0,0,0,0,0
2364,134326,3007,Block 3007,8,33.7031199,-84.3777107,8,5,3,5,1,4,0,0,0,0,0
2365,134327,3008,Block 3008,35,33.7010266,-84.374824,35,18,17,18,1,17,0,0,0,0,0
2366,134328,3009,Block 3009,20,33.7021264,-84.3774924,20,15,5,15,2,13,0,0,0,0,0
2367,134329,3010,Block 3010,37,33.6992385,-84.3793239,37,28,9,28,7,21,0,0,0,0,0
2368,134330,3011,Block 3011,18,33.7011396,-84.3773482,18,11,7,11,2,9,0,0,0,0,0
2369,134331,3012,Block 3012,30,33.6999499,-84.377075,30,24,6,24,8,16,0,0,0,0,0
2370,134332,3013,Block 3013,45,33.6980727,-84.3761913,45,43,2,43,4,38,1,0,0,0,0
2371,134333,3014,Block 3014,5,33.6981911,-84.3727211,5,2,3,2,0,2,0,0,0,0,0
2372,134335,4000,Block 4000,92,33.703979,-84.3709871,92,82,10,82,0,82,0,0,0,0,0
2373,134336,4001,Block 4001,94,33.7058963,-84.3742426,94,85,9,85,0,85,0,0,0,0,0
2374,134337,4002,Block 4002,8,33.7059996,-84.3763475,8,6,2,6,1,5,0,0,0,0,0
2375,134339,4004,Block 4004,6,33.6995711,-84.3638739,6,5,1,5,0,5,0,0,0,0,0
2376,134340,4005,Block 4005,5,33.6963407,-84.3665773,5,3,2,3,0,3,0,0,0,0,0
2377,134341,4006,Block 4006,14,33.7051021,-84.3753138,14,8,6,8,0,8,0,0,0,0,0
2378,134342,4007,Block 4007,2,33.7050935,-84.3774633,2,0,2,0,0,0,0,0,0,0,0
2379,134343,4008,Block 4008,22,33.7041514,-84.3764914,22,8,14,8,1,7,0,0,0,0,0
2380,134347,1000,Block 1000,28,33.6985223,-84.363118,28,21,7,21,0,21,0,0,0,0,0
2381,134348,1001,Block 1001,20,33.6974076,-84.3619806,20,15,5,15,0,15,0,0,0,0,0
2382,134349,1002,Block 1002,15,33.697345,-84.3646282,15,13,2,13,0,13,0,0,0,0,0
2383,134350,1003,Block 1003,10,33.6958929,-84.3646332,10,9,1,9,0,9,0,0,0,0,0
2384,134351,1004,Block 1004,8,33.6965553,-84.364197,8,7,1,7,0,7,0,0,0,0,0
2385,134352,1005,Block 1005,17,33.6961131,-84.3631263,17,14,3,14,0,14,0,0,0,0,0
2386,134353,1006,Block 1006,18,33.6961613,-84.3618068,18,10,8,10,0,10,0,0,0,0,0
2387,134354,1007,Block 1007,26,33.6947555,-84.3614669,26,22,4,22,0,21,0,0,0,0,1
2388,134355,1008,Block 1008,168,33.6945646,-84.3566945,168,158,10,158,2,152,1,0,0,2,1
2389,134357,1010,Block 1010,19,33.6920877,-84.3584844,19,17,2,17,2,15,0,0,0,0,0
2390,134358,1011,Block 1011,113,33.6920741,-84.3538125,113,81,32,81,3,77,0,0,0,0,1
2391,134360,1013,Block 1013,9,33.6909599,-84.3504004,9,4,5,4,0,4,0,0,0,0,0
2392,134361,1014,Block 1014,9,33.6907023,-84.3515937,9,6,3,6,0,6,0,0,0,0,0
2393,134362,1015,Block 1015,13,33.6907056,-84.3568483,13,10,3,10,0,10,0,0,0,0,0
2394,134363,1016,Block 1016,26,33.6900866,-84.3568281,26,18,8,18,2,16,0,0,0,0,0
2395,134364,1017,Block 1017,24,33.6906946,-84.3537677,24,15,9,15,0,13,0,0,0,1,1
2396,134365,1018,Block 1018,11,33.6896104,-84.3537457,11,7,4,7,1,6,0,0,0,0,0
2397,134367,1020,Block 1020,2,33.6865233,-84.3510312,2,1,1,1,0,1,0,0,0,0,0
2398,134372,2000,Block 2000,39,33.7072192,-84.3529243,39,22,17,22,2,18,0,0,0,1,1
2399,134375,2003,Block 2003,27,33.7085066,-84.3573318,27,21,6,21,0,21,0,0,0,0,0
2400,134376,2004,Block 2004,8,33.7025585,-84.3505147,8,6,2,6,0,6,0,0,0,0,0
2401,134378,2006,Block 2006,35,33.7021963,-84.3529262,35,28,7,28,0,28,0,0,0,0,0
2402,134380,2008,Block 2008,34,33.7025495,-84.3566852,34,26,8,26,0,26,0,0,0,0,0
2403,134381,2009,Block 2009,12,33.7015083,-84.3565092,12,10,2,10,0,10,0,0,0,0,0
2404,134382,2010,Block 2010,11,33.7016405,-84.3554883,11,9,2,9,1,8,0,0,0,0,0
2405,134383,2011,Block 2011,17,33.7013756,-84.3543095,17,16,1,16,0,16,0,0,0,0,0
2406,134384,2012,Block 2012,14,33.7010718,-84.3530995,14,13,1,13,0,13,0,0,0,0,0
2407,134385,2013,Block 2013,31,33.6988637,-84.3545659,31,24,7,24,0,24,0,0,0,0,0
2408,134386,2014,Block 2014,66,33.6961817,-84.3525534,66,59,7,59,0,59,0,0,0,0,0
2409,134387,2015,Block 2015,12,33.6967977,-84.3550451,12,7,5,7,0,7,0,0,0,0,0
2410,134388,2016,Block 2016,24,33.6994808,-84.3517511,24,14,10,14,0,14,0,0,0,0,0
2411,134389,2017,Block 2017,29,33.6988402,-84.3531635,29,24,5,24,1,23,0,0,0,0,0
2412,134390,2018,Block 2018,28,33.6983482,-84.3512417,28,19,9,19,0,19,0,0,0,0,0
2413,134391,2019,Block 2019,74,33.6991084,-84.3571195,74,65,9,65,1,64,0,0,0,0,0
2414,134396,1002,Block 1002,29,33.6702587,-84.3532862,29,22,7,22,0,21,0,0,0,1,0
2415,134398,1004,Block 1004,63,33.6725559,-84.361188,63,55,8,55,0,55,0,0,0,0,0
2416,134399,1005,Block 1005,14,33.6710526,-84.358138,14,14,0,14,0,14,0,0,0,0,0
2417,134400,1006,Block 1006,18,33.6699716,-84.3581079,18,17,1,17,0,16,0,0,0,0,1
2418,134401,1007,Block 1007,16,33.6627188,-84.3617792,16,14,2,14,0,14,0,0,0,0,0
2419,134409,1015,Block 1015,226,33.6543888,-84.3602463,226,38,188,38,2,34,0,0,0,1,1
2420,134410,1016,Block 1016,11,33.6573324,-84.3593506,11,11,0,11,0,11,0,0,0,0,0
2421,134412,1018,Block 1018,17,33.6598238,-84.357503,17,17,0,17,0,17,0,0,0,0,0
2422,134417,1023,Block 1023,1,33.648622,-84.3621843,1,1,0,1,0,1,0,0,0,0,0
2423,134419,1025,Block 1025,89,33.6488798,-84.3579128,89,38,51,38,1,35,0,0,0,1,1
2424,134420,1026,Block 1026,131,33.65431,-84.3530905,131,112,19,112,5,105,0,0,0,1,1
2425,134421,1027,Block 1027,21,33.6574684,-84.354826,21,20,1,20,0,20,0,0,0,0,0
2426,134422,1028,Block 1028,39,33.6551593,-84.3572897,39,32,7,32,4,28,0,0,0,0,0
2427,134423,1029,Block 1029,20,33.6577929,-84.3560919,20,15,5,15,1,14,0,0,0,0,0
2428,134424,1030,Block 1030,19,33.6586686,-84.3571572,19,17,2,17,1,16,0,0,0,0,0
2429,134425,1031,Block 1031,15,33.6584296,-84.3581654,15,13,2,13,0,12,0,0,0,1,0
2430,134426,1032,Block 1032,16,33.6571062,-84.3576763,16,12,4,12,1,10,0,0,0,1,0
2431,134427,1033,Block 1033,1,33.6483609,-84.3554438,1,0,1,0,0,0,0,0,0,0,0
2432,134431,2000,Block 2000,52,33.657676,-84.3765006,52,36,16,36,1,35,0,0,0,0,0
2433,134432,2001,Block 2001,10,33.6625907,-84.3786338,10,7,3,7,0,7,0,0,0,0,0
2434,134433,2002,Block 2002,8,33.6590378,-84.3780046,8,8,0,8,1,7,0,0,0,0,0
2435,134434,2003,Block 2003,53,33.6604061,-84.3793317,53,45,8,45,0,43,0,0,0,1,1
2436,134435,2004,Block 2004,19,33.6633532,-84.3796937,19,15,4,15,0,14,0,0,0,0,1
2437,134436,2005,Block 2005,20,33.6567048,-84.3836362,20,17,3,17,0,16,0,0,0,0,1
2438,134460,1000,Block 1000,117,33.6834824,-84.3757491,117,108,9,108,6,97,1,2,0,1,1
2439,134461,1001,Block 1001,25,33.6822907,-84.382157,25,24,1,24,1,21,0,0,0,1,1
2440,134462,1002,Block 1002,11,33.681289,-84.3810351,11,9,2,9,0,9,0,0,0,0,0
2441,134463,1003,Block 1003,31,33.678879,-84.3813338,31,24,7,24,1,23,0,0,0,0,0
2442,134464,1004,Block 1004,72,33.6791635,-84.3768769,72,69,3,69,2,66,1,0,0,0,0
2443,134465,1005,Block 1005,230,33.6784793,-84.3726943,230,222,8,222,4,210,3,0,0,2,3
2444,134466,1006,Block 1006,249,33.6748082,-84.3681788,249,221,28,221,5,213,1,0,0,1,1
2445,134467,1007,Block 1007,14,33.6714284,-84.3678695,14,12,2,12,0,12,0,0,0,0,0
2446,134468,1008,Block 1008,14,33.6713767,-84.3688902,14,13,1,13,0,13,0,0,0,0,0
2447,134470,1010,Block 1010,34,33.6743057,-84.3739005,34,23,11,23,1,22,0,0,0,0,0
2448,134471,1011,Block 1011,1,33.6763391,-84.3743455,1,1,0,1,0,1,0,0,0,0,0
2449,134472,1012,Block 1012,15,33.676044,-84.3768888,15,13,2,13,0,11,0,1,0,0,1
2450,134473,1013,Block 1013,23,33.6747971,-84.3787254,23,19,4,19,1,17,0,0,0,0,1
2451,134474,1014,Block 1014,22,33.6745951,-84.3801513,22,16,6,16,0,14,0,0,0,0,2
2452,134475,1015,Block 1015,22,33.6715465,-84.3791814,22,15,7,15,0,15,0,0,0,0,0
2453,134476,1016,Block 1016,18,33.6747681,-84.3828702,18,17,1,17,4,13,0,0,0,0,0
2454,134477,1017,Block 1017,28,33.6787615,-84.3831548,28,24,4,24,0,23,1,0,0,0,0
2455,134478,1018,Block 1018,7,33.6699043,-84.3660504,7,4,3,4,1,3,0,0,0,0,0
2456,134479,1019,Block 1019,52,33.6646472,-84.3698756,52,46,6,46,2,43,0,1,0,0,0
2457,134480,1020,Block 1020,11,33.6665051,-84.3666416,11,9,2,9,0,9,0,0,0,0,0
2458,134481,1021,Block 1021,1,33.6713665,-84.3740702,1,1,0,1,0,1,0,0,0,0,0
2459,134482,1022,Block 1022,67,33.6673812,-84.3756263,67,54,13,54,1,51,1,0,0,1,0
2460,134483,1023,Block 1023,23,33.6641343,-84.3770158,23,15,8,15,0,15,0,0,0,0,0
2461,134484,1024,Block 1024,16,33.6663489,-84.3776542,16,13,3,13,0,13,0,0,0,0,0
2462,134487,1027,Block 1027,28,33.6659414,-84.3791691,28,23,5,23,0,23,0,0,0,0,0
2463,134489,2000,Block 2000,688,33.6708356,-84.3885599,688,570,118,570,6,557,2,0,0,2,3
2464,134490,2001,Block 2001,4,33.671621,-84.3848219,4,4,0,4,0,3,0,0,0,1,0
2465,134491,2002,Block 2002,4,33.671502,-84.3854723,4,4,0,4,0,3,0,0,0,0,1
2466,134492,2003,Block 2003,40,33.6715942,-84.3951179,40,28,12,28,0,28,0,0,0,0,0
2467,134493,2004,Block 2004,28,33.6680543,-84.3954585,28,18,10,18,0,17,0,1,0,0,0
2468,134494,2005,Block 2005,21,33.670085,-84.3951622,21,15,6,15,0,14,0,0,0,1,0
2469,134495,2006,Block 2006,17,33.6699221,-84.3939548,17,8,9,8,1,7,0,0,0,0,0
2470,134496,2007,Block 2007,11,33.6695709,-84.3962669,11,8,3,8,0,8,0,0,0,0,0
2471,134497,2008,Block 2008,21,33.6680282,-84.3924087,21,19,2,19,0,18,0,0,0,1,0
2472,134498,2009,Block 2009,39,33.6680309,-84.3891894,39,34,5,34,1,33,0,0,0,0,0
2473,134499,2010,Block 2010,31,33.6662621,-84.3881549,31,28,3,28,2,24,2,0,0,0,0
2474,134500,2011,Block 2011,25,33.667206,-84.3898941,25,23,2,23,0,23,0,0,0,0,0
2475,134501,2012,Block 2012,135,33.6641862,-84.3867398,135,121,14,121,1,111,4,0,0,2,3
2476,134505,2016,Block 2016,34,33.6694636,-84.3823948,34,30,4,30,2,28,0,0,0,0,0
2477,134516,3000,Block 3000,25,33.6785995,-84.3862898,25,23,2,23,1,22,0,0,0,0,0
2478,134517,3001,Block 3001,99,33.6795527,-84.391726,99,13,86,13,0,13,0,0,0,0,0
2479,134518,3002,Block 3002,108,33.677723,-84.3960291,108,96,12,96,4,79,1,0,0,11,1
2480,134519,3003,Block 3003,10,33.6773897,-84.3947655,10,4,6,4,1,3,0,0,0,0,0
2481,134521,3005,Block 3005,143,33.6742466,-84.3862142,143,129,14,129,3,122,1,0,0,0,3
2482,134522,3006,Block 3006,23,33.6757851,-84.3874708,23,20,3,20,0,19,0,1,0,0,0
2483,134523,3007,Block 3007,271,33.6749128,-84.3913084,271,256,15,256,3,251,1,0,0,1,0
2484,134524,3008,Block 3008,72,33.6783083,-84.3894719,72,44,28,44,0,43,0,0,0,0,1
2485,134525,3009,Block 3009,28,33.6747042,-84.3943336,28,21,7,21,2,17,0,1,0,1,0
2486,134530,1002,Block 1002,80,33.6850158,-84.4012795,80,75,5,75,13,3,1,1,0,56,1
2487,134531,1003,Block 1003,31,33.6821941,-84.4044583,31,26,5,26,1,23,0,0,0,1,1
2488,134532,1004,Block 1004,46,33.6839559,-84.4024486,46,23,23,23,1,21,0,1,0,0,0
2489,134543,1015,Block 1015,26,33.6778507,-84.3997884,26,18,8,18,3,13,0,1,0,1,0
2490,134544,1016,Block 1016,11,33.6803164,-84.4013075,11,7,4,7,3,4,0,0,0,0,0
2491,134546,1018,Block 1018,20,33.6791137,-84.4025699,20,14,6,14,2,12,0,0,0,0,0
2492,134547,1019,Block 1019,49,33.6790085,-84.4038776,49,33,16,33,7,26,0,0,0,0,0
2493,134548,1020,Block 1020,292,33.6785402,-84.4063976,292,263,29,263,10,233,2,3,0,10,5
2494,134549,1021,Block 1021,26,33.676375,-84.40097,26,16,10,16,0,16,0,0,0,0,0
2495,134550,1022,Block 1022,26,33.6784193,-84.4013757,26,16,10,16,4,11,0,1,0,0,0
2496,134551,1023,Block 1023,17,33.6765962,-84.4026771,17,9,8,9,3,5,0,0,0,1,0
2497,134553,1025,Block 1025,74,33.6741814,-84.3999987,74,57,17,57,6,39,0,0,0,10,2
2498,134554,1026,Block 1026,19,33.6736951,-84.4024073,19,16,3,16,3,11,0,0,0,1,1
2499,134555,1027,Block 1027,33,33.6746058,-84.4029602,33,24,9,24,8,13,0,2,0,1,0
2500,134556,1028,Block 1028,33,33.6753713,-84.4056149,33,23,10,23,6,11,0,3,0,3,0
2501,134558,1030,Block 1030,2,33.673641,-84.4078391,2,1,1,1,0,1,0,0,0,0,0
2502,134559,1031,Block 1031,26,33.6739036,-84.4058649,26,22,4,22,7,12,0,1,0,1,1
2503,134560,1032,Block 1032,21,33.6731354,-84.4029676,21,15,6,15,3,11,0,0,0,1,0
2504,134566,2004,Block 2004,62,33.6770302,-84.410522,62,44,18,44,5,31,0,1,0,7,0
2505,134567,2005,Block 2005,27,33.6749428,-84.411162,27,20,7,20,1,15,0,0,0,4,0
2506,134570,2008,Block 2008,101,33.6774176,-84.4142788,101,88,13,88,5,73,0,0,0,10,0
2507,134573,2011,Block 2011,240,33.6833258,-84.4155823,240,234,6,234,32,201,0,0,0,1,0
2508,134578,2016,Block 2016,173,33.6753425,-84.4171349,173,159,14,159,3,156,0,0,0,0,0
2509,134583,1002,Block 1002,228,33.7012242,-84.4062901,228,207,21,207,9,190,1,0,1,2,4
2510,134584,1003,Block 1003,6,33.7031337,-84.4069894,6,4,2,4,0,4,0,0,0,0,0
2511,134585,1004,Block 1004,2,33.7041585,-84.4066096,2,2,0,2,0,2,0,0,0,0,0
2512,134586,1005,Block 1005,27,33.701329,-84.4099675,27,24,3,24,0,24,0,0,0,0,0
2513,134587,1006,Block 1006,27,33.7007893,-84.4125706,27,23,4,23,3,18,0,1,0,1,0
2514,134588,1007,Block 1007,36,33.7006854,-84.4136581,36,26,10,26,5,20,1,0,0,0,0
2515,134589,1008,Block 1008,65,33.7007447,-84.4153968,65,55,10,55,4,51,0,0,0,0,0
2516,134590,1009,Block 1009,7,33.6996347,-84.4157915,7,4,3,4,0,4,0,0,0,0,0
2517,134591,1010,Block 1010,3,33.7006265,-84.4170375,3,2,1,2,1,1,0,0,0,0,0
2518,134592,1011,Block 1011,9,33.6983429,-84.4174109,9,6,3,6,0,6,0,0,0,0,0
2519,134596,1015,Block 1015,2,33.6969198,-84.4098297,2,1,1,1,0,1,0,0,0,0,0
2520,134601,1020,Block 1020,3,33.6986716,-84.406956,3,2,1,2,0,2,0,0,0,0,0
2521,134610,1029,Block 1029,180,33.6902234,-84.4056109,180,151,29,151,19,125,0,0,0,4,3
2522,134613,1032,Block 1032,24,33.6880467,-84.4044357,24,21,3,21,5,16,0,0,0,0,0
2523,134620,2000,Block 2000,38,33.6876006,-84.4111776,38,29,9,29,3,23,1,0,0,2,0
2524,134621,2001,Block 2001,50,33.6873275,-84.4138334,50,42,8,42,5,35,0,1,0,1,0
2525,134622,2002,Block 2002,26,33.6879268,-84.4151896,26,25,1,25,4,19,0,0,0,2,0
2526,134623,2003,Block 2003,14,33.6880006,-84.4162238,14,13,1,13,2,11,0,0,0,0,0
2527,134624,2004,Block 2004,1,33.6874101,-84.4166447,1,1,0,1,0,1,0,0,0,0,0
2528,134625,2005,Block 2005,3,33.6859177,-84.4165672,3,3,0,3,0,3,0,0,0,0,0
2529,134626,2006,Block 2006,6,33.6859622,-84.4157806,6,5,1,5,1,4,0,0,0,0,0
2530,134627,2007,Block 2007,5,33.6847696,-84.4157272,5,5,0,5,0,5,0,0,0,0,0
2531,134628,2008,Block 2008,25,33.6851306,-84.4116845,25,20,5,20,3,16,0,0,0,1,0
2532,134629,2009,Block 2009,18,33.686474,-84.4122247,18,15,3,15,2,13,0,0,0,0,0
2533,134630,2010,Block 2010,12,33.6876175,-84.4125207,12,7,5,7,0,7,0,0,0,0,0
2534,134631,2011,Block 2011,2,33.6847717,-84.4165132,2,2,0,2,1,1,0,0,0,0,0
2535,134633,2013,Block 2013,1,33.6840097,-84.4156529,1,1,0,1,0,1,0,0,0,0,0
2536,134635,3000,Block 3000,2,33.6963199,-84.4096882,2,1,1,1,0,1,0,0,0,0,0
2537,134638,3003,Block 3003,253,33.6961213,-84.4148092,253,248,5,248,36,208,0,0,0,0,4
2538,134639,3004,Block 3004,30,33.6949069,-84.412896,30,26,4,26,6,20,0,0,0,0,0
2539,134640,3005,Block 3005,13,33.6957721,-84.4101097,13,11,2,11,1,9,0,0,0,0,1
2540,134641,3006,Block 3006,49,33.6934857,-84.4097937,49,39,10,39,1,36,0,0,0,2,0
2541,134642,3007,Block 3007,30,33.6939641,-84.4147407,30,28,2,28,1,24,0,2,0,1,0
2542,134643,3008,Block 3008,34,33.6910205,-84.414929,34,29,5,29,3,25,0,1,0,0,0
2543,134644,3009,Block 3009,20,33.6924551,-84.4127904,20,17,3,17,1,16,0,0,0,0,0
2544,134645,3010,Block 3010,1,33.6920372,-84.4167801,1,1,0,1,1,0,0,0,0,0,0
2545,134646,3011,Block 3011,13,33.6906245,-84.4161279,13,11,2,11,0,11,0,0,0,0,0
2546,134647,3012,Block 3012,19,33.6890665,-84.4095619,19,16,3,16,3,13,0,0,0,0,0
2547,134648,3013,Block 3013,22,33.6908287,-84.4128252,22,20,2,20,2,18,0,0,0,0,0
2548,134649,3014,Block 3014,94,33.6897211,-84.4128272,94,26,68,26,0,26,0,0,0,0,0
2549,134651,4000,Block 4000,239,33.6996995,-84.4219537,239,184,55,184,9,167,1,1,0,4,2
2550,134652,4001,Block 4001,55,33.7010957,-84.4237818,55,39,16,39,7,31,0,0,0,0,1
2551,134653,4002,Block 4002,94,33.7010753,-84.42706,94,83,11,83,3,75,0,0,0,0,5
2552,134654,4003,Block 4003,97,33.6997444,-84.427212,97,86,11,86,4,77,0,0,0,0,5
2553,134655,4004,Block 4004,15,33.6978568,-84.4262118,15,13,2,13,0,12,0,0,0,1,0
2554,134657,4006,Block 4006,3,33.6974821,-84.4237887,3,2,1,2,0,2,0,0,0,0,0
2555,134661,1000,Block 1000,16,33.7139434,-84.4376962,16,11,5,11,0,11,0,0,0,0,0
2556,134662,1001,Block 1001,14,33.7134977,-84.4401816,14,7,7,7,0,6,0,0,0,0,1
2557,134663,1002,Block 1002,19,33.7132947,-84.4415348,19,16,3,16,0,16,0,0,0,0,0
2558,134664,1003,Block 1003,32,33.7138976,-84.444496,32,26,6,26,0,26,0,0,0,0,0
2559,134665,1004,Block 1004,181,33.7123164,-84.4495006,181,156,25,156,0,156,0,0,0,0,0
2560,134666,1005,Block 1005,28,33.7122576,-84.4447432,28,23,5,23,0,23,0,0,0,0,0
2561,134668,2000,Block 2000,22,33.7133242,-84.4529574,22,18,4,18,0,17,0,0,0,0,1
2562,134669,2001,Block 2001,48,33.7133996,-84.4578374,48,39,9,39,0,37,0,0,0,0,2
2563,134670,2002,Block 2002,32,33.7121092,-84.4566605,32,31,1,31,2,29,0,0,0,0,0
2564,134671,2003,Block 2003,19,33.7142628,-84.461428,19,18,1,18,1,17,0,0,0,0,0
2565,134673,2005,Block 2005,166,33.7093586,-84.4575338,166,158,8,158,0,152,0,0,0,1,5
2566,134674,2006,Block 2006,46,33.7089715,-84.4546962,46,34,12,34,0,33,0,0,0,0,1
2567,134675,2007,Block 2007,30,33.7102372,-84.4528842,30,27,3,27,2,25,0,0,0,0,0
2568,134677,3000,Block 3000,51,33.7163575,-84.4701452,51,48,3,48,0,47,0,0,0,0,1
2569,134678,3001,Block 3001,19,33.7184891,-84.4678719,19,18,1,18,1,17,0,0,0,0,0
2570,134679,3002,Block 3002,24,33.7165461,-84.4659235,24,21,3,21,0,21,0,0,0,0,0
2571,134680,3003,Block 3003,91,33.7094637,-84.4649277,91,78,13,78,2,76,0,0,0,0,0
2572,134681,3004,Block 3004,59,33.709648,-84.4717908,59,50,9,50,2,46,2,0,0,0,0
2573,134682,3005,Block 3005,30,33.7051798,-84.4730615,30,26,4,26,0,26,0,0,0,0,0
2574,134683,3006,Block 3006,32,33.7049474,-84.4744293,32,26,6,26,0,25,0,1,0,0,0
2575,134684,3007,Block 3007,40,33.7039176,-84.4750226,40,35,5,35,0,34,0,0,0,0,1
2576,134685,3008,Block 3008,72,33.7046772,-84.4673976,72,59,13,59,0,56,2,0,0,0,1
2577,134688,1000,Block 1000,21,33.7075008,-84.4510502,21,19,2,19,0,19,0,0,0,0,0
2578,134689,1001,Block 1001,147,33.7057679,-84.4523986,147,140,7,140,0,139,0,0,0,0,1
2579,134690,1002,Block 1002,157,33.7066611,-84.4541921,157,143,14,143,0,142,0,0,0,0,1
2580,134691,1003,Block 1003,33,33.7040506,-84.4509256,33,32,1,32,1,31,0,0,0,0,0
2581,134692,1004,Block 1004,159,33.7013463,-84.4510905,159,113,46,113,1,111,0,0,0,0,1
2582,134693,1005,Block 1005,147,33.7000606,-84.4542961,147,113,34,113,0,113,0,0,0,0,0
2583,134695,1007,Block 1007,11,33.6995344,-84.4502367,11,7,4,7,0,7,0,0,0,0,0
2584,134700,2000,Block 2000,393,33.7038364,-84.4561359,393,325,68,325,70,251,0,0,0,0,4
2585,134701,2001,Block 2001,531,33.7029846,-84.4538557,531,381,150,381,5,372,1,0,0,0,3
2586,134703,3000,Block 3000,1,33.7138533,-84.4270326,1,1,0,1,0,1,0,0,0,0,0
2587,134706,3003,Block 3003,34,33.7135727,-84.4309864,34,31,3,31,26,2,0,0,0,0,3
2588,134707,3004,Block 3004,2,33.7127386,-84.4306905,2,2,0,2,1,1,0,0,0,0,0
2589,134712,3009,Block 3009,2,33.7132684,-84.436815,2,2,0,2,0,2,0,0,0,0,0
2590,134714,3011,Block 3011,7,33.709872,-84.4307993,7,5,2,5,3,1,0,0,0,1,0
2591,134717,3014,Block 3014,11,33.7115612,-84.4341783,11,11,0,11,8,1,0,1,0,1,0
2592,134718,3015,Block 3015,3,33.7094849,-84.4386819,3,3,0,3,3,0,0,0,0,0,0
2593,134719,3016,Block 3016,16,33.7104019,-84.4408102,16,16,0,16,13,1,0,2,0,0,0
2594,134720,3017,Block 3017,6,33.7108747,-84.4363399,6,6,0,6,4,1,0,0,0,1,0
2595,134722,3019,Block 3019,21,33.7062025,-84.4374024,21,19,2,19,13,4,0,1,0,0,1
2596,134728,3025,Block 3025,2,33.7053709,-84.4426976,2,2,0,2,2,0,0,0,0,0,0
2597,134729,3026,Block 3026,11,33.7071275,-84.4428648,11,8,3,8,0,8,0,0,0,0,0
2598,134730,3027,Block 3027,116,33.7101529,-84.4428313,116,70,46,70,1,68,0,0,1,0,0
2599,134731,3028,Block 3028,95,33.7098719,-84.4448137,95,66,29,66,2,61,0,0,0,1,2
2600,134732,3029,Block 3029,472,33.707581,-84.4483461,472,437,35,437,7,426,1,0,0,1,2
2601,134733,3030,Block 3030,24,33.7079136,-84.445052,24,17,7,17,0,17,0,0,0,0,0
2602,134734,3031,Block 3031,18,33.706508,-84.4450935,18,15,3,15,1,13,0,0,0,0,1
2603,134755,1000,Block 1000,998,33.7024297,-84.4614403,998,804,194,804,5,785,3,0,0,1,10
2604,134756,1001,Block 1001,11,33.7032073,-84.4580344,11,11,0,11,1,9,1,0,0,0,0
2605,134757,1002,Block 1002,9,33.7028715,-84.4591111,9,9,0,9,1,8,0,0,0,0,0
2606,134759,1004,Block 1004,237,33.7007991,-84.46707,237,194,43,194,0,192,0,0,0,0,2
2607,134760,1005,Block 1005,39,33.7000832,-84.4701077,39,37,2,37,0,37,0,0,0,0,0
2608,134761,1006,Block 1006,11,33.7018408,-84.4721414,11,8,3,8,0,8,0,0,0,0,0
2609,134762,1007,Block 1007,110,33.7012906,-84.4743088,110,76,34,76,3,71,1,0,0,0,1
2610,134763,1008,Block 1008,26,33.6987242,-84.4726531,26,24,2,24,0,24,0,0,0,0,0
2611,134765,1010,Block 1010,1,33.6978911,-84.4691379,1,1,0,1,0,1,0,0,0,0,0
2612,134766,1011,Block 1011,2,33.6990251,-84.4630264,2,1,1,1,0,1,0,0,0,0,0
2613,134771,1000,Block 1000,37,33.7007226,-84.5040501,37,31,6,31,1,29,0,0,0,0,1
2614,134772,1001,Block 1001,27,33.6993812,-84.5029981,27,24,3,24,0,24,0,0,0,0,0
2615,134773,1002,Block 1002,198,33.6961368,-84.5030873,198,185,13,185,2,181,0,0,0,0,2
2616,134774,1003,Block 1003,6,33.6912376,-84.5023967,6,5,1,5,0,5,0,0,0,0,0
2617,134780,1009,Block 1009,26,33.6921551,-84.5046842,26,22,4,22,3,19,0,0,0,0,0
2618,134783,2000,Block 2000,71,33.7039886,-84.5086055,71,67,4,67,2,64,0,0,0,0,1
2619,134784,2001,Block 2001,26,33.7066789,-84.5122569,26,24,2,24,1,23,0,0,0,0,0
2620,134785,2002,Block 2002,24,33.7038193,-84.5132537,24,24,0,24,1,22,0,0,0,0,1
2621,134786,2003,Block 2003,22,33.7038612,-84.5145956,22,19,3,19,0,19,0,0,0,0,0
2622,134787,2004,Block 2004,19,33.7026949,-84.5159996,19,19,0,19,0,18,0,0,0,0,1
2623,134788,2005,Block 2005,20,33.7015328,-84.5166808,20,17,3,17,0,17,0,0,0,0,0
2624,134790,2007,Block 2007,63,33.6940153,-84.5147962,63,53,10,53,1,51,0,1,0,0,0
2625,134791,2008,Block 2008,14,33.694925,-84.5167397,14,14,0,14,0,14,0,0,0,0,0
2626,134792,2009,Block 2009,25,33.7014367,-84.5133089,25,23,2,23,0,23,0,0,0,0,0
2627,134793,2010,Block 2010,25,33.7038552,-84.5117747,25,23,2,23,0,23,0,0,0,0,0
2628,134794,2011,Block 2011,300,33.696716,-84.5141661,300,251,49,251,3,239,0,1,0,0,8
2629,134795,2012,Block 2012,5,33.6919349,-84.5151025,5,5,0,5,0,4,0,1,0,0,0
2630,134796,2013,Block 2013,25,33.7002413,-84.5132805,25,25,0,25,0,25,0,0,0,0,0
2631,134797,2014,Block 2014,17,33.699097,-84.5093968,17,14,3,14,0,14,0,0,0,0,0
2632,134798,2015,Block 2015,31,33.6966024,-84.5073001,31,30,1,30,0,30,0,0,0,0,0
2633,134799,2016,Block 2016,42,33.6931937,-84.5089691,42,40,2,40,1,38,0,1,0,0,0
2634,134800,2017,Block 2017,10,33.6936775,-84.5071987,10,10,0,10,0,10,0,0,0,0,0
2635,134801,2018,Block 2018,50,33.6943043,-84.5120116,50,44,6,44,0,40,1,0,0,1,2
2636,134803,3004,Block 3004,206,33.7101514,-84.5027125,206,200,6,200,3,192,0,1,0,2,2
2637,134804,3005,Block 3005,18,33.7077907,-84.504996,18,17,1,17,0,17,0,0,0,0,0
2638,134805,3006,Block 3006,22,33.7078297,-84.5023304,22,20,2,20,1,19,0,0,0,0,0
2639,134806,3007,Block 3007,21,33.7044869,-84.5009558,21,18,3,18,0,18,0,0,0,0,0
2640,134807,3008,Block 3008,26,33.7005368,-84.5008165,26,25,1,25,1,24,0,0,0,0,0
2641,134808,3009,Block 3009,16,33.7081138,-84.5036611,16,15,1,15,0,15,0,0,0,0,0
2642,134809,3010,Block 3010,26,33.7057894,-84.5047516,26,26,0,26,0,26,0,0,0,0,0
2643,134810,3011,Block 3011,20,33.7057571,-84.501347,20,18,2,18,0,18,0,0,0,0,0
2644,134811,3012,Block 3012,11,33.7071281,-84.5010485,11,10,1,10,0,10,0,0,0,0,0
2645,134812,3013,Block 3013,24,33.703301,-84.5007268,24,23,1,23,0,23,0,0,0,0,0
2646,134813,3014,Block 3014,23,33.7022724,-84.5006888,23,20,3,20,0,20,0,0,0,0,0
2647,134818,3020,Block 3020,30,33.7025552,-84.5041915,30,28,2,28,1,25,0,0,0,1,1
2648,134819,3021,Block 3021,32,33.7043662,-84.5043195,32,29,3,29,0,29,0,0,0,0,0
2649,134822,1000,Block 1000,26,33.7041464,-84.4787322,26,21,5,21,0,21,0,0,0,0,0
2650,134823,1001,Block 1001,453,33.7012115,-84.4839165,453,376,77,376,5,365,0,0,0,0,6
2651,134824,1002,Block 1002,20,33.7030395,-84.4832567,20,0,20,0,0,0,0,0,0,0,0
2652,134826,1004,Block 1004,37,33.6995806,-84.4783094,37,28,9,28,0,25,1,0,0,1,1
2653,134832,2000,Block 2000,28,33.7180506,-84.4726876,28,25,3,25,2,23,0,0,0,0,0
2654,134833,2001,Block 2001,50,33.7159093,-84.477973,50,43,7,43,4,37,0,1,0,0,1
2655,134835,2003,Block 2003,11,33.7181685,-84.48525,11,10,1,10,0,10,0,0,0,0,0
2656,134836,2004,Block 2004,22,33.7174084,-84.4884371,22,21,1,21,0,21,0,0,0,0,0
2657,134837,2005,Block 2005,21,33.713692,-84.487476,21,17,4,17,2,15,0,0,0,0,0
2658,134838,2006,Block 2006,333,33.7103143,-84.4851026,333,293,40,293,2,279,0,4,0,7,1
2659,134839,2007,Block 2007,20,33.7068549,-84.4843681,20,0,20,0,0,0,0,0,0,0,0
2660,134840,2008,Block 2008,41,33.7084471,-84.4878262,41,41,0,41,0,39,0,0,0,0,2
2661,134841,2009,Block 2009,50,33.7113631,-84.4795953,50,45,5,45,2,43,0,0,0,0,0
2662,134842,2010,Block 2010,16,33.7109078,-84.48229,16,15,1,15,0,15,0,0,0,0,0
2663,134843,2011,Block 2011,9,33.7113275,-84.4810396,9,9,0,9,0,9,0,0,0,0,0
2664,134844,2012,Block 2012,12,33.7092008,-84.4786136,12,10,2,10,0,10,0,0,0,0,0
2665,134845,2013,Block 2013,11,33.706716,-84.4781415,11,10,1,10,0,10,0,0,0,0,0
2666,134846,2014,Block 2014,25,33.7079986,-84.480575,25,24,1,24,0,24,0,0,0,0,0
2667,134848,3000,Block 3000,86,33.7182304,-84.4949189,86,83,3,83,0,81,0,0,0,0,2
2668,134849,3001,Block 3001,6,33.7194175,-84.4992185,6,6,0,6,1,5,0,0,0,0,0
2669,134850,3002,Block 3002,7,33.7204826,-84.4972102,7,7,0,7,0,7,0,0,0,0,0
2670,134851,3003,Block 3003,12,33.7210208,-84.498758,12,11,1,11,0,11,0,0,0,0,0
2671,134852,3004,Block 3004,8,33.7216805,-84.4999823,8,8,0,8,1,7,0,0,0,0,0
2672,134855,3009,Block 3009,190,33.7069936,-84.493039,190,176,14,176,3,173,0,0,0,0,0
2673,134856,3010,Block 3010,11,33.6996428,-84.4966535,11,10,1,10,0,10,0,0,0,0,0
2674,134857,3011,Block 3011,64,33.6994133,-84.4976508,64,57,7,57,0,57,0,0,0,0,0
2675,134858,3012,Block 3012,8,33.7020137,-84.4963971,8,7,1,7,0,7,0,0,0,0,0
2676,134859,3013,Block 3013,32,33.705044,-84.4941444,32,29,3,29,1,28,0,0,0,0,0
2677,134861,3015,Block 3015,15,33.6992062,-84.4949085,15,14,1,14,0,13,0,0,0,0,1
2678,134862,3016,Block 3016,6,33.7000303,-84.4951622,6,6,0,6,0,6,0,0,0,0,0
2679,134863,3017,Block 3017,43,33.6990404,-84.4957469,43,42,1,42,0,42,0,0,0,0,0
2680,134864,3018,Block 3018,1,33.7006238,-84.4964917,1,1,0,1,0,1,0,0,0,0,0
2681,134865,3019,Block 3019,15,33.7013821,-84.4964547,15,15,0,15,1,14,0,0,0,0,0
2682,134866,3020,Block 3020,20,33.7130316,-84.491918,20,17,3,17,0,16,0,0,0,0,1
2683,134867,3021,Block 3021,13,33.6968351,-84.4980856,13,13,0,13,1,11,0,0,0,0,1
2684,134868,3022,Block 3022,60,33.6960293,-84.4952488,60,50,10,50,0,49,0,1,0,0,0
2685,134869,3023,Block 3023,18,33.6954165,-84.491415,18,17,1,17,2,15,0,0,0,0,0
2686,134870,3024,Block 3024,28,33.6965284,-84.4883814,28,24,4,24,0,24,0,0,0,0,0
2687,134871,3025,Block 3025,22,33.696056,-84.4901716,22,21,1,21,0,21,0,0,0,0,0
2688,134876,3030,Block 3030,16,33.6924161,-84.4930326,16,14,2,14,0,14,0,0,0,0,0
2689,134877,3031,Block 3031,18,33.6928651,-84.4951753,18,17,1,17,0,17,0,0,0,0,0
2690,134878,3032,Block 3032,27,33.6917618,-84.4963848,27,27,0,27,0,26,1,0,0,0,0
2691,134879,3033,Block 3033,101,33.6942008,-84.4987693,101,62,39,62,0,60,0,0,0,0,2
2692,134884,3038,Block 3038,11,33.6996463,-84.4962609,11,11,0,11,0,11,0,0,0,0,0
2693,134887,1000,Block 1000,89,33.6754294,-84.4897014,89,79,10,79,0,77,0,0,0,0,2
2694,134888,1001,Block 1001,11,33.6756804,-84.4924546,11,10,1,10,0,10,0,0,0,0,0
2695,134889,1002,Block 1002,25,33.6763688,-84.4928762,25,25,0,25,0,25,0,0,0,0,0
2696,134892,1005,Block 1005,34,33.6741242,-84.4977819,34,31,3,31,0,31,0,0,0,0,0
2697,134893,1006,Block 1006,95,33.6742219,-84.496698,95,87,8,87,1,85,1,0,0,0,0
2698,134894,1007,Block 1007,11,33.67189,-84.4946916,11,10,1,10,0,9,0,0,0,0,1
2699,134895,1008,Block 1008,69,33.6729189,-84.4943461,69,65,4,65,0,65,0,0,0,0,0
2700,134898,1011,Block 1011,359,33.668236,-84.4953272,359,257,102,257,5,250,0,0,0,2,0
2701,134899,1012,Block 1012,16,33.6672222,-84.4931497,16,13,3,13,0,13,0,0,0,0,0
2702,134901,2000,Block 2000,25,33.6972314,-84.4801679,25,25,0,25,1,24,0,0,0,0,0
2703,134902,2001,Block 2001,23,33.6964399,-84.4799067,23,20,3,20,0,20,0,0,0,0,0
2704,134903,2002,Block 2002,20,33.6959604,-84.4783353,20,17,3,17,0,17,0,0,0,0,0
2705,134904,2003,Block 2003,18,33.6958838,-84.476939,18,15,3,15,0,15,0,0,0,0,0
2706,134905,2004,Block 2004,14,33.6933739,-84.477273,14,13,1,13,0,12,0,0,0,0,1
2707,134906,2005,Block 2005,13,33.6943758,-84.4780083,13,12,1,12,0,12,0,0,0,0,0
2708,134907,2006,Block 2006,37,33.6953419,-84.4808336,37,33,4,33,0,33,0,0,0,0,0
2709,134908,2007,Block 2007,21,33.6939735,-84.4842968,21,19,2,19,1,17,0,1,0,0,0
2710,134909,2008,Block 2008,9,33.6916104,-84.4869525,9,6,3,6,0,6,0,0,0,0,0
2711,134915,2014,Block 2014,21,33.6942954,-84.4808495,21,18,3,18,1,17,0,0,0,0,0
2712,134916,2015,Block 2015,30,33.6932253,-84.4824832,30,28,2,28,1,27,0,0,0,0,0
2713,134917,2016,Block 2016,21,33.6931886,-84.4801634,21,20,1,20,0,19,0,0,0,0,1
2714,134918,2017,Block 2017,322,33.6827132,-84.4915467,322,273,49,273,1,271,0,0,0,0,1
2715,134919,2018,Block 2018,48,33.683153,-84.4909911,48,41,7,41,0,41,0,0,0,0,0
2716,134920,2019,Block 2019,91,33.6835843,-84.4928268,91,78,13,78,1,76,0,0,0,0,1
2717,134923,2022,Block 2022,16,33.682283,-84.4870798,16,13,3,13,0,13,0,0,0,0,0
2718,134924,2023,Block 2023,17,33.6819801,-84.4898306,17,16,1,16,0,15,0,0,0,0,1
2719,134925,2024,Block 2024,31,33.681865,-84.4889274,31,29,2,29,2,27,0,0,0,0,0
2720,134926,2025,Block 2025,29,33.6821675,-84.4876964,29,27,2,27,2,25,0,0,0,0,0
2721,134927,2026,Block 2026,564,33.6819263,-84.4963697,564,458,106,458,1,452,0,2,0,0,3
2722,134929,2028,Block 2028,10,33.6793167,-84.4889857,10,8,2,8,1,7,0,0,0,0,0
2723,134930,2029,Block 2029,6,33.6795058,-84.4875996,6,5,1,5,0,5,0,0,0,0,0
2724,134931,2030,Block 2030,7,33.68014,-84.4868194,7,6,1,6,0,6,0,0,0,0,0
2725,134932,2031,Block 2031,6,33.6784219,-84.487179,6,6,0,6,1,5,0,0,0,0,0
2726,134933,2032,Block 2032,19,33.6784497,-84.4903991,19,18,1,18,1,17,0,0,0,0,0
2727,134940,1003,Block 1003,315,33.6866817,-84.5032819,315,302,13,302,7,293,0,0,0,0,2
2728,134942,1005,Block 1005,15,33.6839927,-84.5057106,15,12,3,12,1,11,0,0,0,0,0
2729,134943,1006,Block 1006,71,33.6872226,-84.5093835,71,58,13,58,2,56,0,0,0,0,0
2730,134944,1007,Block 1007,16,33.6885048,-84.507137,16,16,0,16,0,16,0,0,0,0,0
2731,134945,1008,Block 1008,20,33.6863302,-84.5057326,20,14,6,14,0,13,0,0,0,1,0
2732,134946,1009,Block 1009,16,33.6835613,-84.5073427,16,13,3,13,0,13,0,0,0,0,0
2733,134947,1010,Block 1010,104,33.6798995,-84.5105952,104,99,5,99,0,96,0,0,0,2,1
2734,134948,1011,Block 1011,16,33.6816516,-84.5073525,16,15,1,15,0,15,0,0,0,0,0
2735,134949,1012,Block 1012,4,33.6794934,-84.5067364,4,3,1,3,0,3,0,0,0,0,0
2736,134950,1013,Block 1013,20,33.6840413,-84.5087661,20,16,4,16,0,16,0,0,0,0,0
2737,134951,1014,Block 1014,11,33.6768828,-84.5123556,11,10,1,10,0,10,0,0,0,0,0
2738,134952,1015,Block 1015,31,33.6757982,-84.5069901,31,23,8,23,1,22,0,0,0,0,0
2739,134953,1016,Block 1016,28,33.6776851,-84.5043414,28,27,1,27,1,26,0,0,0,0,0
2740,134954,1017,Block 1017,339,33.6803779,-84.5024619,339,272,67,272,5,258,1,0,0,2,6
2741,134957,1020,Block 1020,15,33.6755628,-84.5053691,15,14,1,14,0,14,0,0,0,0,0
2742,134958,1021,Block 1021,22,33.6759804,-84.5132435,22,21,1,21,1,20,0,0,0,0,0
2743,134959,1022,Block 1022,51,33.6764993,-84.5097514,51,43,8,43,1,40,2,0,0,0,0
2744,134960,1023,Block 1023,32,33.6747036,-84.5120038,32,31,1,31,1,30,0,0,0,0,0
2745,134961,1024,Block 1024,10,33.6752727,-84.5097579,10,10,0,10,0,10,0,0,0,0,0
2746,134962,1025,Block 1025,29,33.6737172,-84.5123934,29,28,1,28,0,27,1,0,0,0,0
2747,134964,2000,Block 2000,6,33.6896556,-84.514396,6,3,3,3,2,0,0,1,0,0,0
2748,134965,2001,Block 2001,10,33.6903242,-84.5171652,10,9,1,9,0,9,0,0,0,0,0
2749,134966,2002,Block 2002,30,33.691576,-84.5202373,30,24,6,24,1,21,0,0,0,0,2
2750,134967,2003,Block 2003,73,33.6851068,-84.5212569,73,59,14,59,1,57,0,0,1,0,0
2751,134968,2004,Block 2004,37,33.6828367,-84.5317152,37,28,9,28,0,28,0,0,0,0,0
2752,134970,2006,Block 2006,42,33.6782673,-84.5321452,42,39,3,39,0,39,0,0,0,0,0
2753,134971,2008,Block 2008,6,33.6766437,-84.5349669,6,5,1,5,0,4,0,0,0,0,1
2754,134972,2009,Block 2009,21,33.6795523,-84.5150172,21,19,2,19,1,17,0,0,0,0,1
2755,134975,2012,Block 2012,64,33.6739956,-84.522794,64,59,5,59,0,56,0,1,0,2,0
2756,134977,2015,Block 2015,8,33.6745254,-84.5332926,8,6,2,6,0,6,0,0,0,0,0
2757,134979,2022,Block 2022,23,33.6615905,-84.5278536,23,18,5,18,2,16,0,0,0,0,0
2758,134980,2024,Block 2024,19,33.6612499,-84.5266063,19,19,0,19,3,16,0,0,0,0,0
2759,134982,2026,Block 2026,363,33.6608936,-84.5239852,363,315,48,315,5,299,0,1,0,0,10
2760,134989,3003,Block 3003,7,33.6749226,-84.5009669,7,6,1,6,0,6,0,0,0,0,0
2761,134990,3004,Block 3004,21,33.6741117,-84.5040743,21,20,1,20,1,19,0,0,0,0,0
2762,134991,3005,Block 3005,71,33.6724342,-84.5065024,71,69,2,69,2,64,0,0,0,0,3
2763,134992,3006,Block 3006,13,33.6727983,-84.5050704,13,10,3,10,0,10,0,0,0,0,0
2764,134994,3008,Block 3008,87,33.6686089,-84.5021748,87,81,6,81,1,79,0,0,0,1,0
2765,134996,3010,Block 3010,132,33.668414,-84.499789,132,110,22,110,2,103,1,0,0,2,2
2766,134997,3011,Block 3011,45,33.6735284,-84.4998653,45,44,1,44,0,44,0,0,0,0,0
2767,134999,3013,Block 3013,298,33.6621449,-84.5084689,298,217,81,217,21,188,0,3,0,1,4
2768,135000,3014,Block 3014,184,33.663464,-84.5128965,184,172,12,172,9,158,0,1,0,1,3
2769,135001,3015,Block 3015,28,33.6684951,-84.5103792,28,27,1,27,0,25,0,1,0,1,0
2770,135003,3017,Block 3017,14,33.6666568,-84.5102271,14,13,1,13,0,11,0,0,0,2,0
2771,135004,3018,Block 3018,21,33.6654942,-84.5103496,21,19,2,19,2,16,0,1,0,0,0
2772,135005,3019,Block 3019,18,33.6675154,-84.5102816,18,16,2,16,1,14,0,0,0,1,0
2773,135006,3020,Block 3020,13,33.6624674,-84.5119908,13,11,2,11,2,9,0,0,0,0,0
2774,135007,3021,Block 3021,73,33.670688,-84.5126791,73,69,4,69,2,64,0,3,0,0,0
2775,135008,3022,Block 3022,15,33.6693014,-84.5109969,15,15,0,15,1,14,0,0,0,0,0
2776,135009,3023,Block 3023,199,33.6684476,-84.5178977,199,187,12,187,6,174,0,2,0,4,1
2777,135010,3024,Block 3024,43,33.6669803,-84.5158428,43,38,5,38,0,38,0,0,0,0,0
2778,135011,3025,Block 3025,70,33.664003,-84.5162396,70,66,4,66,1,62,0,3,0,0,0
2779,135012,3026,Block 3026,17,33.6644115,-84.5153365,17,15,2,15,0,14,0,1,0,0,0
2780,135014,3028,Block 3028,169,33.6604477,-84.5184064,169,151,18,151,5,142,1,1,0,0,2
2781,135015,3029,Block 3029,14,33.6617602,-84.5154552,14,12,2,12,0,12,0,0,0,0,0
2782,135016,3030,Block 3030,5,33.6589874,-84.516814,5,5,0,5,0,5,0,0,0,0,0
2783,135017,3031,Block 3031,25,33.664408,-84.5175829,25,21,4,21,0,19,0,0,0,0,2
2784,135020,3034,Block 3034,3,33.660728,-84.5223274,3,3,0,3,0,3,0,0,0,0,0
2785,135025,3039,Block 3039,350,33.6580111,-84.508001,350,307,43,307,19,268,0,6,0,3,11
2786,135039,1005,Block 1005,596,33.7107525,-84.5264585,596,479,117,479,5,462,2,2,0,1,7
2787,135040,1007,Block 1007,32,33.7143952,-84.5299315,32,28,4,28,1,26,0,0,0,0,1
2788,135041,1008,Block 1008,35,33.712926,-84.5234856,35,26,9,26,0,26,0,0,0,0,0
2789,135043,1010,Block 1010,3,33.7179501,-84.5240687,3,3,0,3,0,2,0,0,0,0,1
2790,135044,1011,Block 1011,24,33.7028498,-84.5231422,24,21,3,21,0,21,0,0,0,0,0
2791,135045,1012,Block 1012,54,33.7236789,-84.5273001,54,53,1,53,0,52,1,0,0,0,0
2792,135046,1013,Block 1013,1,33.7178516,-84.5256927,1,1,0,1,1,0,0,0,0,0,0
2793,135048,1015,Block 1015,4,33.7160769,-84.5183081,4,2,2,2,0,2,0,0,0,0,0
2794,135049,1017,Block 1017,1,33.7210066,-84.5164715,1,1,0,1,0,1,0,0,0,0,0
2795,135050,1019,Block 1019,25,33.6998516,-84.5215449,25,18,7,18,1,17,0,0,0,0,0
2796,135051,1020,Block 1020,625,33.6969895,-84.5192915,625,451,174,451,12,430,3,0,0,2,4
2797,135052,1021,Block 1021,16,33.7033459,-84.5205435,16,15,1,15,1,14,0,0,0,0,0
2798,135053,1022,Block 1022,4,33.7090754,-84.5191568,4,4,0,4,0,4,0,0,0,0,0
2799,135055,1024,Block 1024,39,33.7108182,-84.5099286,39,36,3,36,1,35,0,0,0,0,0
2800,135057,1029,Block 1029,7,33.7129774,-84.5074816,7,7,0,7,0,7,0,0,0,0,0
2801,135058,1030,Block 1030,4,33.7158698,-84.5334598,4,4,0,4,0,4,0,0,0,0,0
2802,135059,1031,Block 1031,27,33.7112708,-84.5322991,27,24,3,24,0,24,0,0,0,0,0
2803,135060,1032,Block 1032,24,33.7155173,-84.5224004,24,21,3,21,0,20,0,0,0,0,1
2804,135062,1034,Block 1034,1,33.7087911,-84.5204802,1,1,0,1,0,0,0,0,0,0,1
2805,135066,2006,Block 2006,90,33.7054797,-84.5441946,90,82,8,82,1,81,0,0,0,0,0
2806,135067,2007,Block 2007,18,33.7083704,-84.5421557,18,18,0,18,0,18,0,0,0,0,0
2807,135068,2008,Block 2008,3,33.7086852,-84.5392095,3,2,1,2,0,2,0,0,0,0,0
2808,135069,2009,Block 2009,6,33.7085923,-84.5373585,6,6,0,6,0,6,0,0,0,0,0
2809,135070,2010,Block 2010,68,33.7064253,-84.5394487,68,65,3,65,0,65,0,0,0,0,0
2810,135071,2012,Block 2012,53,33.7018744,-84.5325251,53,46,7,46,2,42,1,0,0,0,1
2811,135072,2013,Block 2013,189,33.6994573,-84.5400258,189,173,16,173,1,170,0,1,0,0,1
2812,135073,2014,Block 2014,3,33.6989227,-84.544998,3,3,0,3,0,3,0,0,0,0,0
2813,135074,2015,Block 2015,25,33.7038678,-84.5410899,25,22,3,22,1,21,0,0,0,0,0
2814,135075,2016,Block 2016,24,33.7041192,-84.5395404,24,23,1,23,0,22,0,0,0,1,0
2815,135076,2018,Block 2018,3,33.7014023,-84.5458978,3,3,0,3,0,3,0,0,0,0,0
2816,135078,3000,Block 3000,46,33.6934542,-84.5247278,46,37,9,37,2,34,1,0,0,0,0
2817,135079,3001,Block 3001,18,33.6924632,-84.5228308,18,9,9,9,2,7,0,0,0,0,0
2818,135080,3002,Block 3002,27,33.691473,-84.5234252,27,21,6,21,2,17,0,0,0,2,0
2819,135081,3003,Block 3003,49,33.6934521,-84.5316393,49,38,11,38,0,36,0,0,1,0,1
2820,135082,3004,Block 3004,107,33.6867494,-84.532267,107,96,11,96,0,95,0,0,0,0,1
2821,135083,3005,Block 3005,24,33.6885326,-84.5322428,24,19,5,19,0,19,0,0,0,0,0
2822,135084,3006,Block 3006,6,33.6900297,-84.5264807,6,4,2,4,0,4,0,0,0,0,0
2823,135085,3007,Block 3007,4,33.6906106,-84.5243985,4,4,0,4,0,4,0,0,0,0,0
2824,135086,3008,Block 3008,26,33.6915778,-84.5294039,26,20,6,20,0,19,0,1,0,0,0
2825,135088,4000,Block 4000,249,33.7302633,-84.5337678,249,229,20,229,9,218,0,1,0,0,1
2826,135089,4001,Block 4001,10,33.7286729,-84.5346135,10,10,0,10,0,10,0,0,0,0,0
2827,135090,4002,Block 4002,12,33.7326601,-84.5367593,12,12,0,12,0,12,0,0,0,0,0
2828,135091,4003,Block 4003,12,33.7316091,-84.5353134,12,11,1,11,0,11,0,0,0,0,0
2829,135092,4004,Block 4004,18,33.7186333,-84.5345953,18,16,2,16,0,16,0,0,0,0,0
2830,135094,4019,Block 4019,5,33.7116992,-84.5351561,5,5,0,5,0,5,0,0,0,0,0
2831,135095,4020,Block 4020,3,33.713702,-84.5354814,3,3,0,3,0,3,0,0,0,0,0
2832,135096,4021,Block 4021,2,33.7150262,-84.5358907,2,2,0,2,0,2,0,0,0,0,0
2833,135100,1000,Block 1000,5,33.770495,-84.5145956,5,2,3,2,0,1,0,0,0,1,0
2834,135101,1024,Block 1024,123,33.7668287,-84.5137786,123,70,53,70,30,21,2,0,0,14,3
2835,135103,1026,Block 1026,183,33.7633274,-84.5124711,183,176,7,176,0,175,0,0,1,0,0
2836,135104,1046,Block 1046,1,33.748572,-84.5394081,1,1,0,1,0,1,0,0,0,0,0
2837,135105,1047,Block 1047,170,33.7566992,-84.5267513,170,150,20,150,1,144,1,0,0,0,4
2838,135106,1048,Block 1048,18,33.7614946,-84.519908,18,18,0,18,0,17,0,0,0,0,1
2839,135107,1049,Block 1049,21,33.7585352,-84.5207014,21,20,1,20,0,20,0,0,0,0,0
2840,135108,1050,Block 1050,26,33.7525537,-84.5337706,26,23,3,23,1,22,0,0,0,0,0
2841,135111,2021,Block 2021,51,33.7487863,-84.5330206,51,38,13,38,0,38,0,0,0,0,0
2842,135112,2022,Block 2022,25,33.7439311,-84.531359,25,21,4,21,0,21,0,0,0,0,0
2843,135113,2023,Block 2023,79,33.7443671,-84.5252765,79,68,11,68,0,68,0,0,0,0,0
2844,135114,2024,Block 2024,30,33.7430969,-84.5267802,30,26,4,26,0,26,0,0,0,0,0
2845,135115,2025,Block 2025,19,33.7428049,-84.5239526,19,18,1,18,0,18,0,0,0,0,0
2846,135116,2026,Block 2026,15,33.7409615,-84.5251508,15,12,3,12,0,11,0,0,0,0,1
2847,135117,2027,Block 2027,16,33.7414267,-84.5265846,16,13,3,13,0,12,0,0,0,1,0
2848,135118,2028,Block 2028,3,33.7401217,-84.5310771,3,2,1,2,0,2,0,0,0,0,0
2849,135122,1000,Block 1000,27,33.7606992,-84.5155438,27,24,3,24,1,22,0,0,0,0,1
2850,135123,1001,Block 1001,26,33.7613202,-84.5172961,26,22,4,22,0,22,0,0,0,0,0
2851,135124,1002,Block 1002,15,33.7604041,-84.5174302,15,11,4,11,0,11,0,0,0,0,0
2852,135125,1003,Block 1003,12,33.7593693,-84.5172815,12,9,3,9,0,9,0,0,0,0,0
2853,135126,1004,Block 1004,103,33.7582343,-84.5163435,103,92,11,92,1,89,0,0,0,0,2
2854,135127,1005,Block 1005,7,33.7568349,-84.5181663,7,6,1,6,0,6,0,0,0,0,0
2855,135128,1006,Block 1006,9,33.7557888,-84.5180541,9,6,3,6,0,6,0,0,0,0,0
2856,135129,1007,Block 1007,4,33.7576107,-84.5181538,4,4,0,4,0,3,0,0,0,1,0
2857,135130,1008,Block 1008,90,33.7529923,-84.5183994,90,83,7,83,1,82,0,0,0,0,0
2858,135131,1009,Block 1009,30,33.7511162,-84.5197053,30,27,3,27,0,26,0,1,0,0,0
2859,135132,1010,Block 1010,33,33.7547378,-84.5158828,33,31,2,31,0,31,0,0,0,0,0
2860,135133,1011,Block 1011,13,33.7526075,-84.5173215,13,13,0,13,0,13,0,0,0,0,0
2861,135134,1012,Block 1012,26,33.7532692,-84.5156254,26,25,1,25,0,25,0,0,0,0,0
2862,135135,1013,Block 1013,20,33.7529163,-84.5204049,20,19,1,19,0,18,0,0,0,0,1
2863,135136,1014,Block 1014,95,33.7499271,-84.5234853,95,89,6,89,1,88,0,0,0,0,0
2864,135137,1015,Block 1015,19,33.7535904,-84.5204141,19,19,0,19,0,19,0,0,0,0,0
2865,135138,1016,Block 1016,12,33.7516203,-84.5208833,12,11,1,11,0,11,0,0,0,0,0
2866,135139,1017,Block 1017,9,33.7504578,-84.5235436,9,9,0,9,0,9,0,0,0,0,0
2867,135140,1018,Block 1018,20,33.7506435,-84.5214432,20,20,0,20,0,20,0,0,0,0,0
2868,135141,1019,Block 1019,12,33.752263,-84.520875,12,11,1,11,0,11,0,0,0,0,0
2869,135142,1020,Block 1020,34,33.7487008,-84.5162698,34,30,4,30,0,30,0,0,0,0,0
2870,135144,2000,Block 2000,884,33.7383966,-84.5126747,884,778,106,778,2,764,0,1,0,1,10
2871,135145,2001,Block 2001,18,33.743977,-84.5147708,18,18,0,18,0,18,0,0,0,0,0
2872,135146,2003,Block 2003,6,33.7459578,-84.5145823,6,6,0,6,0,6,0,0,0,0,0
2873,135147,2004,Block 2004,130,33.7398393,-84.5108021,130,109,21,109,0,107,2,0,0,0,0
2874,135149,2006,Block 2006,1,33.7362212,-84.5097629,1,1,0,1,0,1,0,0,0,0,0
2875,135150,2007,Block 2007,88,33.7384292,-84.5197167,88,76,12,76,0,74,0,0,0,0,2
2876,135152,2009,Block 2009,31,33.7391327,-84.5182036,31,26,5,26,0,26,0,0,0,0,0
2877,135153,2012,Block 2012,24,33.7455267,-84.5206802,24,22,2,22,0,22,0,0,0,0,0
2878,135154,2013,Block 2013,15,33.7460027,-84.5170303,15,14,1,14,0,14,0,0,0,0,0
2879,135155,2014,Block 2014,5,33.7460701,-84.5158656,5,5,0,5,0,5,0,0,0,0,0
2880,135156,2015,Block 2015,34,33.7412884,-84.5174525,34,33,1,33,0,33,0,0,0,0,0
2881,135157,2016,Block 2016,9,33.7416064,-84.5170887,9,9,0,9,0,9,0,0,0,0,0
2882,135158,2017,Block 2017,12,33.7425172,-84.5169168,12,10,2,10,0,9,0,0,0,1,0
2883,135159,2018,Block 2018,20,33.7435257,-84.5174204,20,19,1,19,0,19,0,0,0,0,0
2884,135161,3000,Block 3000,44,33.7608096,-84.5106777,44,40,4,40,0,39,0,0,0,0,1
2885,135162,3001,Block 3001,41,33.757976,-84.5092131,41,38,3,38,0,38,0,0,0,0,0
2886,135163,3002,Block 3002,22,33.7591413,-84.5103513,22,21,1,21,0,21,0,0,0,0,0
2887,135164,3003,Block 3003,53,33.757849,-84.5111908,53,47,6,47,0,47,0,0,0,0,0
2888,135165,3004,Block 3004,1,33.7586742,-84.5110587,1,1,0,1,0,1,0,0,0,0,0
2889,135166,3005,Block 3005,84,33.7547965,-84.5133433,84,75,9,75,0,74,0,0,0,1,0
2890,135167,3006,Block 3006,12,33.7483749,-84.5141829,12,11,1,11,0,11,0,0,0,0,0
2891,135168,3007,Block 3007,6,33.7484059,-84.5122877,6,4,2,4,0,4,0,0,0,0,0
2892,135169,3008,Block 3008,40,33.7511875,-84.5101926,40,38,2,38,0,38,0,0,0,0,0
2893,135170,3009,Block 3009,32,33.7545582,-84.508533,32,32,0,32,0,32,0,0,0,0,0
2894,135171,3010,Block 3010,38,33.7573745,-84.5071496,38,35,3,35,0,35,0,0,0,0,0
2895,135172,3011,Block 3011,22,33.7544176,-84.5062892,22,19,3,19,0,19,0,0,0,0,0
2896,135173,3012,Block 3012,42,33.7521921,-84.5081681,42,38,4,38,0,38,0,0,0,0,0
2897,135176,1000,Block 1000,50,33.7674083,-84.4978469,50,45,5,45,0,45,0,0,0,0,0
2898,135177,1001,Block 1001,58,33.7676925,-84.5032464,58,49,9,49,0,47,0,0,0,0,2
2899,135178,1002,Block 1002,18,33.7676949,-84.5006895,18,16,2,16,1,13,0,0,0,0,2
2900,135179,1003,Block 1003,20,33.7676199,-84.5064063,20,19,1,19,2,17,0,0,0,0,0
2901,135180,1004,Block 1004,23,33.7676613,-84.5073907,23,23,0,23,0,23,0,0,0,0,0
2902,135181,1005,Block 1005,25,33.7677716,-84.5084126,25,22,3,22,0,22,0,0,0,0,0
2903,135182,1006,Block 1006,298,33.7682809,-84.5109775,298,144,154,144,12,75,0,0,0,55,2
2904,135183,1007,Block 1007,41,33.7663009,-84.5053687,41,36,5,36,0,36,0,0,0,0,0
2905,135188,1012,Block 1012,140,33.7614448,-84.4975265,140,112,28,112,2,107,0,2,1,0,0
2906,135190,1014,Block 1014,72,33.7636673,-84.5061829,72,59,13,59,3,30,0,0,1,23,2
2907,135191,1015,Block 1015,79,33.7635652,-84.5028025,79,71,8,71,1,70,0,0,0,0,0
2908,135192,1016,Block 1016,26,33.7643252,-84.5035998,26,20,6,20,0,19,0,0,0,1,0
2909,135193,1017,Block 1017,14,33.7625919,-84.5016248,14,11,3,11,0,10,0,0,0,1,0
2910,135194,1018,Block 1018,188,33.7597959,-84.5026521,188,145,43,145,2,141,1,0,0,1,0
2911,135195,1019,Block 1019,4,33.7577008,-84.4952227,4,4,0,4,0,4,0,0,0,0,0
2912,135199,2000,Block 2000,22,33.7641548,-84.488556,22,19,3,19,0,19,0,0,0,0,0
2913,135214,2015,Block 2015,57,33.7575305,-84.4909519,57,52,5,52,1,48,0,0,0,2,1
2914,135215,2016,Block 2016,37,33.7566023,-84.4912889,37,32,5,32,1,28,0,0,0,3,0
2915,135216,2017,Block 2017,137,33.7580735,-84.4874395,137,101,36,101,0,100,0,0,0,0,1
2916,135217,2018,Block 2018,21,33.7581727,-84.4863241,21,18,3,18,0,18,0,0,0,0,0
2917,135222,1001,Block 1001,16,33.7555659,-84.4974154,16,12,4,12,1,11,0,0,0,0,0
2918,135225,1004,Block 1004,63,33.7530215,-84.5030849,63,52,11,52,0,49,0,0,0,0,3
2919,135226,1005,Block 1005,57,33.755597,-84.5045826,57,45,12,45,2,39,1,0,0,0,3
2920,135228,1007,Block 1007,31,33.7520799,-84.5010732,31,27,4,27,0,26,0,0,0,1,0
2921,135229,1008,Block 1008,5,33.7540242,-84.4987422,5,2,3,2,0,2,0,0,0,0,0
2922,135230,1009,Block 1009,18,33.7522629,-84.4983979,18,12,6,12,0,12,0,0,0,0,0
2923,135232,1011,Block 1011,2,33.7511388,-84.4992106,2,2,0,2,0,2,0,0,0,0,0
2924,135233,1012,Block 1012,33,33.7507653,-84.5061783,33,28,5,28,0,28,0,0,0,0,0
2925,135234,1013,Block 1013,601,33.7455657,-84.5065912,601,565,36,565,4,552,0,0,0,1,8
2926,135236,2000,Block 2000,505,33.7540221,-84.4874345,505,404,101,404,47,330,2,0,0,22,3
2927,135237,2001,Block 2001,199,33.7537094,-84.4893254,199,190,9,190,1,185,0,0,0,0,4
2928,135238,2002,Block 2002,111,33.7540349,-84.4917708,111,81,30,81,0,81,0,0,0,0,0
2929,135239,2003,Block 2003,145,33.7544045,-84.4938781,145,106,39,106,4,93,0,0,0,8,1
2930,135247,1000,Block 1000,11,33.7451477,-84.4878995,11,10,1,10,0,9,0,0,0,1,0
2931,135248,1001,Block 1001,158,33.7365115,-84.4843732,158,145,13,145,2,140,1,0,0,0,2
2932,135249,1002,Block 1002,21,33.7375135,-84.4880907,21,18,3,18,0,18,0,0,0,0,0
2933,135250,1003,Block 1003,45,33.733508,-84.4787332,45,45,0,45,0,45,0,0,0,0,0
2934,135251,1004,Block 1004,31,33.7370064,-84.4786116,31,30,1,30,0,29,0,0,0,0,1
2935,135252,1005,Block 1005,14,33.7379263,-84.4834284,14,14,0,14,1,13,0,0,0,0,0
2936,135253,1006,Block 1006,31,33.7325302,-84.4763822,31,31,0,31,0,31,0,0,0,0,0
2937,135254,1007,Block 1007,28,33.7345503,-84.4875949,28,25,3,25,0,25,0,0,0,0,0
2938,135255,1008,Block 1008,35,33.7311208,-84.4736365,35,33,2,33,1,32,0,0,0,0,0
2939,135256,1009,Block 1009,19,33.7279303,-84.4818977,19,17,2,17,0,17,0,0,0,0,0
2940,135257,1010,Block 1010,27,33.7295846,-84.4840334,27,25,2,25,0,25,0,0,0,0,0
2941,135258,1011,Block 1011,118,33.7248017,-84.4815371,118,108,10,108,3,103,0,0,0,0,2
2942,135259,1012,Block 1012,148,33.7232575,-84.4759995,148,132,16,132,1,131,0,0,0,0,0
2943,135260,1013,Block 1013,15,33.728384,-84.4715879,15,15,0,15,0,15,0,0,0,0,0
2944,135262,2000,Block 2000,23,33.7346348,-84.4939254,23,23,0,23,0,23,0,0,0,0,0
2945,135263,2001,Block 2001,13,33.7329349,-84.4940871,13,8,5,8,0,8,0,0,0,0,0
2946,135264,2002,Block 2002,27,33.7322732,-84.4910511,27,22,5,22,0,22,0,0,0,0,0
2947,135265,2003,Block 2003,11,33.7315085,-84.494258,11,9,2,9,0,8,0,0,0,0,1
2948,135266,2004,Block 2004,16,33.7299599,-84.494365,16,15,1,15,1,14,0,0,0,0,0
2949,135267,2005,Block 2005,27,33.7298411,-84.4914747,27,27,0,27,0,27,0,0,0,0,0
2950,135268,2006,Block 2006,73,33.7267759,-84.486846,73,64,9,64,2,61,0,0,0,0,1
2951,135269,2007,Block 2007,42,33.7282419,-84.4920608,42,42,0,42,0,42,0,0,0,0,0
2952,135270,2008,Block 2008,14,33.7222289,-84.4893743,14,13,1,13,0,12,0,0,0,0,1
2953,135271,2009,Block 2009,36,33.7256467,-84.4914978,36,34,2,34,0,32,1,0,0,0,1
2954,135272,2010,Block 2010,25,33.7269757,-84.4907581,25,24,1,24,0,24,0,0,0,0,0
2955,135273,2011,Block 2011,13,33.7268872,-84.4941891,13,12,1,12,0,12,0,0,0,0,0
2956,135274,2012,Block 2012,18,33.7214771,-84.4931442,18,16,2,16,1,15,0,0,0,0,0
2957,135275,2013,Block 2013,33,33.7242419,-84.4925342,33,32,1,32,0,31,0,0,0,0,1
2958,135276,2014,Block 2014,16,33.7210537,-84.4872203,16,15,1,15,0,14,0,1,0,0,0
2959,135279,3001,Block 3001,417,33.7476643,-84.5007283,417,298,119,298,7,278,1,0,0,1,11
2960,135282,3004,Block 3004,2,33.7438706,-84.5036864,2,1,1,1,0,0,0,0,0,0,1
2961,135285,3007,Block 3007,22,33.744856,-84.5026328,22,20,2,20,0,20,0,0,0,0,0
2962,135286,3008,Block 3008,8,33.7431673,-84.5034915,8,8,0,8,0,8,0,0,0,0,0
2963,135291,3013,Block 3013,28,33.744774,-84.5037063,28,27,1,27,1,26,0,0,0,0,0
2964,135294,3016,Block 3016,17,33.7470191,-84.5007225,17,17,0,17,0,16,0,1,0,0,0
2965,135295,3020,Block 3020,1,33.735519,-84.5038939,1,1,0,1,0,1,0,0,0,0,0
2966,135297,3022,Block 3022,2,33.740487,-84.5015722,2,1,1,1,0,1,0,0,0,0,0
2967,135300,3025,Block 3025,1,33.7453738,-84.4979494,1,1,0,1,0,1,0,0,0,0,0
2968,135301,3026,Block 3026,20,33.7411561,-84.4982005,20,16,4,16,0,16,0,0,0,0,0
2969,135302,3027,Block 3027,53,33.742953,-84.4941496,53,49,4,49,2,47,0,0,0,0,0
2970,135303,3028,Block 3028,4,33.7452244,-84.4910973,4,4,0,4,0,4,0,0,0,0,0
2971,135304,3029,Block 3029,66,33.7394685,-84.494711,66,64,2,64,0,64,0,0,0,0,0
2972,135305,3030,Block 3030,11,33.7380896,-84.4931485,11,11,0,11,0,11,0,0,0,0,0
2973,135306,3031,Block 3031,7,33.7358016,-84.4910291,7,6,1,6,0,6,0,0,0,0,0
2974,135307,3032,Block 3032,6,33.7345906,-84.4896955,6,5,1,5,0,5,0,0,0,0,0
2975,135311,3036,Block 3036,26,33.7339468,-84.5006508,26,26,0,26,0,26,0,0,0,0,0
2976,135312,3037,Block 3037,18,33.7379873,-84.4976979,18,18,0,18,0,18,0,0,0,0,0
2977,135313,3039,Block 3039,3,33.7281984,-84.5013882,3,3,0,3,1,2,0,0,0,0,0
2978,135314,3040,Block 3040,3,33.7293373,-84.501362,3,3,0,3,0,3,0,0,0,0,0
2979,135315,3041,Block 3041,3,33.7303687,-84.50142,3,2,1,2,0,2,0,0,0,0,0
2980,135316,3043,Block 3043,30,33.7271703,-84.4961755,30,29,1,29,0,29,0,0,0,0,0
2981,135317,3044,Block 3044,8,33.7282673,-84.4961314,8,7,1,7,1,6,0,0,0,0,0
2982,135318,3045,Block 3045,13,33.7299275,-84.4961363,13,13,0,13,1,12,0,0,0,0,0
2983,135319,3046,Block 3046,25,33.7314988,-84.4975539,25,25,0,25,0,25,0,0,0,0,0
2984,135320,3047,Block 3047,47,33.7343033,-84.4971988,47,41,6,41,0,41,0,0,0,0,0
2985,135321,3048,Block 3048,10,33.7356218,-84.4991834,10,8,2,8,0,8,0,0,0,0,0
2986,135322,3049,Block 3049,18,33.7364392,-84.4980449,18,17,1,17,0,17,0,0,0,0,0
2987,135323,3050,Block 3050,25,33.7328539,-84.4987396,25,22,3,22,0,22,0,0,0,0,0
2988,135325,3054,Block 3054,23,33.7282352,-84.4990339,23,20,3,20,0,19,0,0,0,0,1
2989,135326,3055,Block 3055,21,33.7293381,-84.4990295,21,19,2,19,0,18,0,0,0,0,1
2990,135327,3056,Block 3056,22,33.7304086,-84.499007,22,22,0,22,0,21,0,0,0,1,0
2991,135328,3057,Block 3057,73,33.7228448,-84.4939466,73,71,2,71,1,68,0,0,0,0,2
2992,135343,1000,Block 1000,96,33.7186851,-84.4334019,96,74,22,74,3,71,0,0,0,0,0
2993,135344,1001,Block 1001,87,33.7184733,-84.4348669,87,63,24,63,1,60,0,0,0,1,1
2994,135345,1002,Block 1002,89,33.7184575,-84.4360288,89,56,33,56,5,46,1,0,0,0,4
2995,135346,1003,Block 1003,55,33.7188456,-84.4368351,55,38,17,38,2,35,0,0,0,0,1
2996,135347,1004,Block 1004,41,33.7204987,-84.4382029,41,26,15,26,1,24,1,0,0,0,0
2997,135348,1005,Block 1005,46,33.7181802,-84.4373861,46,38,8,38,0,38,0,0,0,0,0
2998,135349,1006,Block 1006,44,33.7165442,-84.43824,44,35,9,35,2,33,0,0,0,0,0
2999,135351,2000,Block 2000,96,33.7202624,-84.4432125,96,77,19,77,2,75,0,0,0,0,0
3000,135352,2001,Block 2001,14,33.7217792,-84.4429182,14,12,2,12,0,12,0,0,0,0,0
3001,135353,2002,Block 2002,37,33.7209936,-84.4459167,37,30,7,30,2,28,0,0,0,0,0
3002,135354,2003,Block 2003,54,33.7176732,-84.4404378,54,49,5,49,0,49,0,0,0,0,0
3003,135355,2004,Block 2004,64,33.7179771,-84.4393136,64,56,8,56,1,53,0,0,0,1,1
3004,135356,2005,Block 2005,28,33.7153996,-84.4427572,28,22,6,22,2,20,0,0,0,0,0
3005,135357,2006,Block 2006,36,33.7178212,-84.4428494,36,28,8,28,0,28,0,0,0,0,0
3006,135358,2007,Block 2007,47,33.7178362,-84.4415716,47,41,6,41,0,41,0,0,0,0,0
3007,135359,2008,Block 2008,41,33.7161497,-84.4454517,41,36,5,36,0,35,0,0,0,0,1
3008,135361,3000,Block 3000,50,33.7204723,-84.4475834,50,38,12,38,0,36,1,0,0,0,1
3009,135362,3001,Block 3001,35,33.720446,-84.4491953,35,29,6,29,0,29,0,0,0,0,0
3010,135363,3002,Block 3002,39,33.7208832,-84.4510341,39,31,8,31,0,31,0,0,0,0,0
3011,135364,3003,Block 3003,46,33.7180453,-84.4499934,46,41,5,41,0,41,0,0,0,0,0
3012,135365,3004,Block 3004,22,33.7165503,-84.4480952,22,21,1,21,1,20,0,0,0,0,0
3013,135366,3005,Block 3005,18,33.7160517,-84.4506043,18,17,1,17,0,17,0,0,0,0,0
3014,135367,3006,Block 3006,24,33.7161558,-84.4524655,24,21,3,21,2,19,0,0,0,0,0
3015,135368,3007,Block 3007,25,33.7153261,-84.4481745,25,23,2,23,0,23,0,0,0,0,0
3016,135370,4000,Block 4000,22,33.7205967,-84.4535316,22,20,2,20,0,20,0,0,0,0,0
3017,135372,4002,Block 4002,64,33.7184293,-84.4571219,64,53,11,53,3,47,1,1,0,1,0
3018,135373,4003,Block 4003,20,33.721333,-84.4590082,20,16,4,16,1,14,1,0,0,0,0
3019,135374,4004,Block 4004,18,33.7217812,-84.4613847,18,15,3,15,0,15,0,0,0,0,0
3020,135375,4005,Block 4005,5,33.7217167,-84.4633159,5,5,0,5,0,5,0,0,0,0,0
3021,135377,4007,Block 4007,106,33.7223764,-84.4693272,106,83,23,83,2,80,0,0,0,0,1
3022,135379,4009,Block 4009,19,33.7201091,-84.459187,19,15,4,15,0,15,0,0,0,0,0
3023,135380,4010,Block 4010,11,33.7205326,-84.4613662,11,9,2,9,0,9,0,0,0,0,0
3024,135381,4011,Block 4011,17,33.7202302,-84.4630334,17,13,4,13,0,13,0,0,0,0,0
3025,135382,4012,Block 4012,31,33.7198279,-84.4646219,31,28,3,28,1,27,0,0,0,0,0
3026,135383,4013,Block 4013,15,33.7200171,-84.4671201,15,13,2,13,0,13,0,0,0,0,0
3027,135384,4014,Block 4014,10,33.7192793,-84.46171,10,10,0,10,2,8,0,0,0,0,0
3028,135385,4015,Block 4015,24,33.7188883,-84.4593429,24,22,2,22,2,20,0,0,0,0,0
3029,135386,4016,Block 4016,16,33.7176416,-84.4593968,16,14,2,14,0,12,0,1,0,0,1
3030,135387,4017,Block 4017,4,33.7183393,-84.4615777,4,3,1,3,0,3,0,0,0,0,0
3031,135388,4018,Block 4018,18,33.7175698,-84.4627961,18,18,0,18,2,16,0,0,0,0,0
3032,135389,4019,Block 4019,22,33.7162311,-84.460092,22,20,2,20,2,18,0,0,0,0,0
3033,135390,4020,Block 4020,19,33.7154884,-84.4548146,19,15,4,15,1,14,0,0,0,0,0
3034,135391,4021,Block 4021,33,33.7185337,-84.4556239,33,30,3,30,1,27,0,0,0,0,2
3035,135392,4022,Block 4022,30,33.7179338,-84.4539056,30,26,4,26,0,26,0,0,0,0,0
3036,135393,4023,Block 4023,4,33.7160979,-84.4558451,4,4,0,4,0,4,0,0,0,0,0
3037,135395,5000,Block 5000,115,33.7273157,-84.4538273,115,92,23,92,2,84,1,0,0,1,4
3038,135396,5001,Block 5001,42,33.7298876,-84.4597628,42,38,4,38,2,36,0,0,0,0,0
3039,135397,5002,Block 5002,2,33.7316838,-84.4545891,2,1,1,1,0,1,0,0,0,0,0
3040,135398,5003,Block 5003,45,33.7326264,-84.4603573,45,34,11,34,1,33,0,0,0,0,0
3041,135399,5004,Block 5004,79,33.7341156,-84.4635102,79,75,4,75,0,74,0,0,0,1,0
3042,135400,5005,Block 5005,26,33.7362618,-84.4609858,26,25,1,25,0,22,0,0,0,0,3
3043,135401,5006,Block 5006,12,33.7347274,-84.459077,12,11,1,11,0,11,0,0,0,0,0
3044,135402,5007,Block 5007,32,33.7353987,-84.4714521,32,29,3,29,0,28,0,0,0,1,0
3045,135403,5008,Block 5008,10,33.7320722,-84.468996,10,10,0,10,0,10,0,0,0,0,0
3046,135404,5009,Block 5009,65,33.7267589,-84.4660187,65,56,9,56,2,52,0,0,0,0,2
3047,135405,5010,Block 5010,28,33.7302037,-84.4631776,28,26,2,26,2,24,0,0,0,0,0
3048,135406,5011,Block 5011,25,33.7286297,-84.4639845,25,24,1,24,2,22,0,0,0,0,0
3049,135407,5012,Block 5012,22,33.7246282,-84.4635164,22,14,8,14,1,13,0,0,0,0,0
3050,135408,5013,Block 5013,101,33.7242389,-84.4621745,101,78,23,78,2,76,0,0,0,0,0
3051,135409,5014,Block 5014,3,33.7339521,-84.4564178,3,3,0,3,0,3,0,0,0,0,0
3052,135410,5015,Block 5015,20,33.7264347,-84.4689599,20,19,1,19,0,19,0,0,0,0,0
3053,135414,1000,Block 1000,20,33.7390194,-84.4516529,20,16,4,16,0,16,0,0,0,0,0
3054,135415,1001,Block 1001,15,33.7381139,-84.4521774,15,13,2,13,0,13,0,0,0,0,0
3055,135416,1002,Block 1002,18,33.7381191,-84.4533277,18,17,1,17,0,17,0,0,0,0,0
3056,135417,1003,Block 1003,14,33.7381297,-84.4544844,14,13,1,13,0,13,0,0,0,0,0
3057,135418,1004,Block 1004,30,33.7376033,-84.4568498,30,26,4,26,0,25,0,0,0,0,1
3058,135419,1005,Block 1005,12,33.7381414,-84.4556337,12,12,0,12,0,12,0,0,0,0,0
3059,135420,1006,Block 1006,17,33.7380995,-84.4510311,17,16,1,16,1,15,0,0,0,0,0
3060,135421,1007,Block 1007,16,33.7380817,-84.4497166,16,11,5,11,0,8,0,1,0,0,2
3061,135422,1008,Block 1008,27,33.7380752,-84.4478653,27,25,2,25,0,24,0,0,0,0,1
3062,135423,1009,Block 1009,46,33.7356301,-84.4480709,46,41,5,41,0,40,0,1,0,0,0
3063,135424,1010,Block 1010,36,33.7354742,-84.4497594,36,30,6,30,0,30,0,0,0,0,0
3064,135425,1011,Block 1011,17,33.7366305,-84.4510362,17,17,0,17,0,17,0,0,0,0,0
3065,135426,1012,Block 1012,17,33.7366458,-84.4521712,17,17,0,17,0,17,0,0,0,0,0
3066,135427,1013,Block 1013,15,33.7366523,-84.4533212,15,12,3,12,0,12,0,0,0,0,0
3067,135428,1014,Block 1014,33,33.73541,-84.452186,33,30,3,30,2,27,0,0,0,0,1
3068,135429,1015,Block 1015,23,33.7343519,-84.4521783,23,22,1,22,0,22,0,0,0,0,0
3069,135430,1016,Block 1016,24,33.7328384,-84.4517914,24,22,2,22,0,22,0,0,0,0,0
3070,135431,1017,Block 1017,58,33.7316178,-84.4500478,58,44,14,44,1,40,1,0,0,1,1
3071,135432,1018,Block 1018,9,33.7319622,-84.4488571,9,7,2,7,0,7,0,0,0,0,0
3072,135440,1005,Block 1005,182,33.7533045,-84.4665182,182,161,21,161,3,155,0,0,0,3,0
3073,135441,1006,Block 1006,6,33.7529428,-84.4645155,6,4,2,4,0,4,0,0,0,0,0
3074,135442,1007,Block 1007,14,33.7511902,-84.4629098,14,6,8,6,0,6,0,0,0,0,0
3075,135443,1008,Block 1008,309,33.750686,-84.4512663,309,100,209,100,3,91,0,0,0,0,6
3076,135444,1009,Block 1009,37,33.7506301,-84.4603229,37,22,15,22,0,21,0,0,0,1,0
3077,135446,1011,Block 1011,3,33.7515268,-84.4502998,3,2,1,2,0,2,0,0,0,0,0
3078,135448,1013,Block 1013,6,33.7442726,-84.4532162,6,5,1,5,0,5,0,0,0,0,0
3079,135449,1014,Block 1014,23,33.7465359,-84.4618206,23,15,8,15,0,15,0,0,0,0,0
3080,135450,1015,Block 1015,22,33.7464303,-84.460412,22,16,6,16,0,15,0,0,0,0,1
3081,135451,1016,Block 1016,37,33.7465232,-84.4588395,37,27,10,27,0,26,1,0,0,0,0
3082,135452,1017,Block 1017,40,33.7469284,-84.4573632,40,31,9,31,1,30,0,0,0,0,0
3083,135453,1018,Block 1018,23,33.7492745,-84.4577253,23,19,4,19,0,18,0,0,0,1,0
3084,135454,1019,Block 1019,37,33.7493344,-84.4600639,37,20,17,20,0,20,0,0,0,0,0
3085,135455,1020,Block 1020,28,33.7488757,-84.4625904,28,18,10,18,0,18,0,0,0,0,0
3086,135456,1021,Block 1021,21,33.7498684,-84.4644709,21,17,4,17,0,17,0,0,0,0,0
3087,135457,1022,Block 1022,24,33.750031,-84.4653745,24,20,4,20,0,20,0,0,0,0,0
3088,135458,1023,Block 1023,35,33.7500339,-84.4663242,35,18,17,18,0,18,0,0,0,0,0
3089,135459,1024,Block 1024,19,33.7482746,-84.4642907,19,16,3,16,0,16,0,0,0,0,0
3090,135461,1026,Block 1026,4,33.7510952,-84.447146,4,2,2,2,0,1,0,0,0,0,1
3091,135462,1027,Block 1027,34,33.7481371,-84.4600796,34,23,11,23,0,23,0,0,0,0,0
3092,135463,1028,Block 1028,1,33.7460323,-84.4612755,1,1,0,1,0,1,0,0,0,0,0
3093,135465,2000,Block 2000,199,33.741889,-84.4717149,199,179,20,179,0,177,0,0,0,0,2
3094,135467,2002,Block 2002,84,33.7451379,-84.4749525,84,80,4,80,0,80,0,0,0,0,0
3095,135468,2003,Block 2003,20,33.747482,-84.4711404,20,20,0,20,0,19,0,0,0,0,1
3096,135469,2004,Block 2004,51,33.746183,-84.4649445,51,41,10,41,0,41,0,0,0,0,0
3097,135472,2007,Block 2007,19,33.7475074,-84.4725178,19,18,1,18,0,18,0,0,0,0,0
3098,135482,3008,Block 3008,23,33.749886,-84.4948419,23,20,3,20,1,19,0,0,0,0,0
3099,135483,3009,Block 3009,345,33.7482842,-84.4920557,345,185,160,185,8,145,1,0,0,28,3
3100,135484,3010,Block 3010,203,33.7477843,-84.4959301,203,196,7,196,0,195,0,1,0,0,0
3101,135485,3011,Block 3011,122,33.7477096,-84.4847491,122,94,28,94,6,83,1,0,0,1,3
3102,135486,3012,Block 3012,9,33.7463308,-84.4879387,9,7,2,7,0,7,0,0,0,0,0
3103,135490,4002,Block 4002,5,33.7540403,-84.4766371,5,3,2,3,0,3,0,0,0,0,0
3104,135491,4003,Block 4003,1,33.7535469,-84.469583,1,0,1,0,0,0,0,0,0,0,0
3105,135493,4005,Block 4005,860,33.7513278,-84.472525,860,781,79,781,6,754,3,2,0,2,14
3106,135494,4006,Block 4006,367,33.7497089,-84.4792351,367,273,94,273,7,244,1,0,0,17,4
3107,135495,4007,Block 4007,11,33.746379,-84.4812416,11,11,0,11,0,11,0,0,0,0,0
3108,135496,4008,Block 4008,10,33.7462495,-84.4827765,10,8,2,8,0,8,0,0,0,0,0
3109,135497,4009,Block 4009,20,33.7452287,-84.4837517,20,19,1,19,1,18,0,0,0,0,0
3110,135498,4010,Block 4010,27,33.7431283,-84.4803243,27,22,5,22,0,22,0,0,0,0,0
3111,135499,4011,Block 4011,12,33.7429931,-84.4826993,12,12,0,12,1,11,0,0,0,0,0
3112,135500,4012,Block 4012,11,33.7429979,-84.4840435,11,10,1,10,0,10,0,0,0,0,0
3113,135501,4013,Block 4013,11,33.7415177,-84.4831736,11,10,1,10,0,10,0,0,0,0,0
3114,135502,4014,Block 4014,12,33.7419961,-84.481354,12,12,0,12,1,11,0,0,0,0,0
3115,135505,1000,Block 1000,102,33.7672343,-84.4747067,102,84,18,84,0,82,1,0,0,0,1
3116,135506,1001,Block 1001,21,33.7684064,-84.4727744,21,19,2,19,1,18,0,0,0,0,0
3117,135507,1002,Block 1002,53,33.7666404,-84.4722781,53,45,8,45,0,44,0,0,0,1,0
3118,135508,1003,Block 1003,18,33.7657579,-84.4744063,18,12,6,12,0,12,0,0,0,0,0
3119,135509,1004,Block 1004,19,33.7644496,-84.4711365,19,16,3,16,0,16,0,0,0,0,0
3120,135510,1005,Block 1005,33,33.7641048,-84.4744586,33,30,3,30,1,28,0,0,0,0,1
3121,135511,1006,Block 1006,33,33.7655539,-84.4793475,33,29,4,29,0,28,0,0,0,0,1
3122,135512,1007,Block 1007,21,33.7669822,-84.4789545,21,19,2,19,0,19,0,0,0,0,0
3123,135513,1008,Block 1008,35,33.7664323,-84.4774555,35,23,12,23,0,23,0,0,0,0,0
3124,135514,1009,Block 1009,29,33.7620673,-84.4762934,29,27,2,27,0,26,0,0,0,1,0
3125,135515,1010,Block 1010,21,33.7634781,-84.4791216,21,19,2,19,0,19,0,0,0,0,0
3126,135516,1011,Block 1011,3,33.7637604,-84.4813769,3,3,0,3,0,3,0,0,0,0,0
3127,135517,1012,Block 1012,10,33.7655807,-84.4811741,10,10,0,10,0,10,0,0,0,0,0
3128,135518,1013,Block 1013,45,33.7648435,-84.4834697,45,42,3,42,0,42,0,0,0,0,0
3129,135519,1014,Block 1014,81,33.766853,-84.4885455,81,71,10,71,0,71,0,0,0,0,0
3130,135520,1015,Block 1015,15,33.7683357,-84.4889812,15,13,2,13,1,11,0,0,0,0,1
3131,135521,1016,Block 1016,15,33.766538,-84.4862426,15,14,1,14,0,14,0,0,0,0,0
3132,135522,1017,Block 1017,17,33.7683385,-84.4862532,17,17,0,17,0,17,0,0,0,0,0
3133,135523,1018,Block 1018,12,33.768466,-84.4876717,12,11,1,11,0,11,0,0,0,0,0
3134,135524,1019,Block 1019,23,33.7618082,-84.4819628,23,21,2,21,0,21,0,0,0,0,0
3135,135525,1020,Block 1020,48,33.761846,-84.4780878,48,41,7,41,0,40,0,0,0,0,1
3136,135526,1021,Block 1021,13,33.7609529,-84.4751395,13,12,1,12,0,11,0,0,0,0,1
3137,135527,1022,Block 1022,44,33.7598624,-84.4718606,44,34,10,34,0,34,0,0,0,0,0
3138,135528,1023,Block 1023,78,33.7619599,-84.472378,78,69,9,69,2,66,0,0,0,0,1
3139,135533,1028,Block 1028,33,33.7584315,-84.479983,33,30,3,30,2,28,0,0,0,0,0
3140,135534,1029,Block 1029,88,33.7572795,-84.4737722,88,77,11,77,1,75,0,0,0,0,1
3141,135535,1030,Block 1030,23,33.7572846,-84.472948,23,18,5,18,0,18,0,0,0,0,0
3142,135536,1031,Block 1031,40,33.7567146,-84.4719088,40,36,4,36,0,36,0,0,0,0,0
3143,135537,1032,Block 1032,11,33.7567905,-84.4756975,11,9,2,9,0,9,0,0,0,0,0
3144,135539,1034,Block 1034,44,33.7568121,-84.4793667,44,38,6,38,0,37,1,0,0,0,0
3145,135540,1035,Block 1035,14,33.7552571,-84.4772932,14,7,7,7,0,7,0,0,0,0,0
3146,135541,1036,Block 1036,1,33.7551835,-84.470705,1,0,1,0,0,0,0,0,0,0,0
3147,135544,2000,Block 2000,165,33.7826064,-84.4895531,165,143,22,143,0,135,1,0,0,2,5
3148,135545,2001,Block 2001,34,33.7790762,-84.4879858,34,31,3,31,0,30,0,0,0,0,1
3149,135546,2002,Block 2002,12,33.7786497,-84.4859331,12,11,1,11,0,11,0,0,0,0,0
3150,135547,2003,Block 2003,38,33.779774,-84.4830542,38,34,4,34,0,33,0,0,0,1,0
3151,135548,2004,Block 2004,39,33.7783735,-84.4789985,39,37,2,37,0,37,0,0,0,0,0
3152,135549,2005,Block 2005,105,33.7758671,-84.4867133,105,102,3,102,0,100,2,0,0,0,0
3153,135550,2006,Block 2006,26,33.7746524,-84.4884593,26,25,1,25,0,24,1,0,0,0,0
3154,135551,2007,Block 2007,12,33.7747322,-84.4845708,12,10,2,10,0,10,0,0,0,0,0
3155,135552,2008,Block 2008,17,33.7745654,-84.486035,17,17,0,17,0,16,0,0,0,0,1
3156,135553,2009,Block 2009,137,33.7729806,-84.4819844,137,121,16,121,1,117,1,0,0,0,2
3157,135554,2010,Block 2010,14,33.7736058,-84.4779575,14,13,1,13,0,13,0,0,0,0,0
3158,135555,2011,Block 2011,434,33.7756071,-84.4785338,434,409,25,409,3,395,0,0,0,0,11
3159,135556,2012,Block 2012,28,33.7764396,-84.4806518,28,23,5,23,0,23,0,0,0,0,0
3160,135557,2013,Block 2013,10,33.7752503,-84.4749017,10,9,1,9,0,9,0,0,0,0,0
3161,135558,2014,Block 2014,19,33.772707,-84.4742039,19,17,2,17,1,14,0,0,0,0,2
3162,135559,2015,Block 2015,20,33.7727317,-84.4754247,20,19,1,19,0,19,0,0,0,0,0
3163,135560,2016,Block 2016,161,33.7699414,-84.4792012,161,147,14,147,0,144,0,0,0,0,3
3164,135561,2017,Block 2017,15,33.7712486,-84.4809378,15,13,2,13,0,13,0,0,0,0,0
3165,135562,2018,Block 2018,15,33.7683531,-84.4833165,15,13,2,13,1,12,0,0,0,0,0
3166,135566,3002,Block 3002,106,33.7820338,-84.494863,106,90,16,90,2,88,0,0,0,0,0
3167,135567,3003,Block 3003,30,33.7816807,-84.4940999,30,28,2,28,0,28,0,0,0,0,0
3168,135568,3004,Block 3004,49,33.7774333,-84.4937419,49,45,4,45,0,44,0,0,0,0,1
3169,135569,3005,Block 3005,45,33.7820041,-84.4922619,45,39,6,39,0,39,0,0,0,0,0
3170,135570,3006,Block 3006,22,33.7747385,-84.4950975,22,18,4,18,0,18,0,0,0,0,0
3171,135571,3007,Block 3007,27,33.7792063,-84.4931199,27,25,2,25,1,24,0,0,0,0,0
3172,135572,3008,Block 3008,90,33.780338,-84.4931707,90,70,20,70,0,70,0,0,0,0,0
3173,135573,3009,Block 3009,48,33.781131,-84.4924035,48,38,10,38,0,38,0,0,0,0,0
3174,135576,3012,Block 3012,97,33.7729314,-84.4912379,97,90,7,90,0,87,0,0,0,1,2
3175,135577,3013,Block 3013,10,33.7748264,-84.4928711,10,10,0,10,0,10,0,0,0,0,0
3176,135578,3014,Block 3014,7,33.7755788,-84.4928988,7,6,1,6,0,6,0,0,0,0,0
3177,135579,3015,Block 3015,11,33.7763426,-84.4930007,11,10,1,10,0,10,0,0,0,0,0
3178,135580,3016,Block 3016,13,33.7739471,-84.4931182,13,11,2,11,1,10,0,0,0,0,0
3179,135581,3017,Block 3017,16,33.7750425,-84.494108,16,14,2,14,0,13,0,0,0,0,1
3180,135584,1000,Block 1000,42,33.7808573,-84.5043615,42,29,13,29,1,25,2,0,0,0,1
3181,135585,1001,Block 1001,4,33.7799027,-84.5071226,4,2,2,2,0,2,0,0,0,0,0
3182,135587,1003,Block 1003,79,33.7747215,-84.5024193,79,69,10,69,0,67,1,0,0,0,1
3183,135588,1004,Block 1004,30,33.7725583,-84.5033678,30,26,4,26,0,24,0,0,0,0,2
3184,135589,1005,Block 1005,9,33.7727827,-84.5057237,9,7,2,7,0,7,0,0,0,0,0
3185,135590,1006,Block 1006,27,33.778216,-84.5013506,27,16,11,16,0,16,0,0,0,0,0
3186,135591,1007,Block 1007,35,33.7784375,-84.5028507,35,32,3,32,0,32,0,0,0,0,0
3187,135592,1008,Block 1008,21,33.7789326,-84.5036364,21,17,4,17,0,16,0,0,0,0,1
3188,135593,1009,Block 1009,41,33.7787533,-84.5061296,41,32,9,32,0,31,1,0,0,0,0
3189,135594,1010,Block 1010,61,33.7770054,-84.509817,61,49,12,49,1,48,0,0,0,0,0
3190,135595,1011,Block 1011,17,33.7723384,-84.5066534,17,14,3,14,0,14,0,0,0,0,0
3191,135597,2000,Block 2000,58,33.7769024,-84.5056474,58,51,7,51,0,51,0,0,0,0,0
3192,135598,2001,Block 2001,18,33.7765482,-84.5077153,18,12,6,12,0,12,0,0,0,0,0
3193,135599,2002,Block 2002,20,33.7756958,-84.507676,20,17,3,17,0,16,0,0,0,1,0
3194,135600,2003,Block 2003,16,33.774845,-84.506871,16,14,2,14,0,14,0,0,0,0,0
3195,135601,2004,Block 2004,18,33.7746569,-84.5088552,18,15,3,15,0,15,0,0,0,0,0
3196,135602,2005,Block 2005,22,33.7733942,-84.5077781,22,21,1,21,1,20,0,0,0,0,0
3197,135603,2006,Block 2006,59,33.7715917,-84.5116536,59,46,13,46,0,46,0,0,0,0,0
3198,135604,2007,Block 2007,15,33.7732169,-84.5103758,15,14,1,14,0,14,0,0,0,0,0
3199,135605,2008,Block 2008,17,33.7723227,-84.510134,17,16,1,16,0,16,0,0,0,0,0
3200,135606,2009,Block 2009,21,33.7757263,-84.5124346,21,20,1,20,0,20,0,0,0,0,0
3201,135607,2010,Block 2010,44,33.7758523,-84.5112805,44,39,5,39,0,39,0,0,0,0,0
3202,135608,2011,Block 2011,40,33.7702025,-84.5042651,40,32,8,32,0,32,0,0,0,0,0
3203,135611,3001,Block 3001,156,33.780037,-84.4967118,156,103,53,103,2,100,0,0,0,0,1
3204,135613,3003,Block 3003,13,33.7747514,-84.4988457,13,9,4,9,0,9,0,0,0,0,0
3205,135624,1000,Block 1000,101,33.7680359,-84.4479231,101,78,23,78,2,72,0,0,0,0,4
3206,135626,1002,Block 1002,12,33.7689414,-84.4577012,12,10,2,10,0,10,0,0,0,0,0
3207,135627,1003,Block 1003,17,33.7692246,-84.4585724,17,14,3,14,0,14,0,0,0,0,0
3208,135628,1004,Block 1004,49,33.769012,-84.4601108,49,36,13,36,0,36,0,0,0,0,0
3209,135629,1005,Block 1005,44,33.7690198,-84.4626614,44,36,8,36,2,34,0,0,0,0,0
3210,135630,1006,Block 1006,31,33.7686802,-84.465086,31,22,9,22,0,22,0,0,0,0,0
3211,135631,1007,Block 1007,47,33.7666531,-84.4685264,47,39,8,39,0,38,0,0,0,0,1
3212,135632,1008,Block 1008,23,33.7686036,-84.4693135,23,19,4,19,0,19,0,0,0,0,0
3213,135633,1009,Block 1009,18,33.7687198,-84.4706719,18,14,4,14,1,13,0,0,0,0,0
3214,135634,1010,Block 1010,54,33.7662403,-84.4419073,54,23,31,23,0,22,0,0,0,0,1
3215,135635,1011,Block 1011,119,33.7647448,-84.445407,119,84,35,84,1,80,1,0,0,1,1
3216,135636,1012,Block 1012,41,33.7660226,-84.454424,41,23,18,23,0,22,0,0,0,0,1
3217,135637,1013,Block 1013,27,33.7659471,-84.4457442,27,23,4,23,1,22,0,0,0,0,0
3218,135638,1014,Block 1014,10,33.76474,-84.4482887,10,10,0,10,0,10,0,0,0,0,0
3219,135639,1015,Block 1015,91,33.76621,-84.4527871,91,60,31,60,4,56,0,0,0,0,0
3220,135640,1016,Block 1016,37,33.7642537,-84.4539691,37,19,18,19,1,18,0,0,0,0,0
3221,135641,1017,Block 1017,33,33.7664065,-84.4505373,33,22,11,22,0,22,0,0,0,0,0
3222,135642,1018,Block 1018,19,33.7652392,-84.4551374,19,9,10,9,0,9,0,0,0,0,0
3223,135643,1019,Block 1019,2,33.766417,-84.4483028,2,1,1,1,0,1,0,0,0,0,0
3224,135644,1020,Block 1020,336,33.7657944,-84.463359,336,201,135,201,4,192,0,1,0,0,4
3225,135645,1021,Block 1021,14,33.7665461,-84.446419,14,13,1,13,0,13,0,0,0,0,0
3226,135646,1022,Block 1022,60,33.7650791,-84.4505081,60,16,44,16,0,16,0,0,0,0,0
3227,135648,2000,Block 2000,26,33.7632441,-84.4519842,26,15,11,15,0,15,0,0,0,0,0
3228,135650,2002,Block 2002,14,33.7623688,-84.4528893,14,10,4,10,0,10,0,0,0,0,0
3229,135651,2003,Block 2003,51,33.7623942,-84.4540845,51,25,26,25,2,23,0,0,0,0,0
3230,135652,2004,Block 2004,7,33.7629473,-84.4557885,7,4,3,4,0,4,0,0,0,0,0
3231,135656,2008,Block 2008,28,33.7569858,-84.4657453,28,25,3,25,0,25,0,0,0,0,0
3232,135657,2009,Block 2009,36,33.760467,-84.4679337,36,32,4,32,0,32,0,0,0,0,0
3233,135658,2010,Block 2010,16,33.7593158,-84.4675423,16,14,2,14,0,14,0,0,0,0,0
3234,135662,2014,Block 2014,21,33.7618556,-84.4554131,21,13,8,13,1,12,0,0,0,0,0
3235,135663,2015,Block 2015,26,33.7606341,-84.4537116,26,19,7,19,0,19,0,0,0,0,0
3236,135664,2016,Block 2016,12,33.7609515,-84.4513536,12,9,3,9,0,9,0,0,0,0,0
3237,135666,2018,Block 2018,71,33.7575854,-84.4641383,71,40,31,40,0,39,0,0,0,0,1
3238,135667,2019,Block 2019,29,33.7610164,-84.4636697,29,17,12,17,0,17,0,0,0,0,0
3239,135668,2020,Block 2020,37,33.761033,-84.4578989,37,24,13,24,1,23,0,0,0,0,0
3240,135669,2021,Block 2021,32,33.7604557,-84.4620163,32,27,5,27,0,27,0,0,0,0,0
3241,135672,1000,Block 1000,114,33.7574426,-84.4538244,114,72,42,72,0,72,0,0,0,0,0
3242,135673,1001,Block 1001,14,33.7560846,-84.4576476,14,8,6,8,0,8,0,0,0,0,0
3243,135674,1002,Block 1002,24,33.759541,-84.4593258,24,16,8,16,1,15,0,0,0,0,0
3244,135675,1003,Block 1003,19,33.7587994,-84.460498,19,14,5,14,0,14,0,0,0,0,0
3245,135676,1004,Block 1004,203,33.7553408,-84.4609791,203,66,137,66,0,66,0,0,0,0,0
3246,135677,1005,Block 1005,29,33.7588991,-84.4626601,29,22,7,22,0,22,0,0,0,0,0
3247,135678,1006,Block 1006,13,33.7565357,-84.4626605,13,4,9,4,0,3,0,0,0,0,1
3248,135679,1007,Block 1007,90,33.7527663,-84.455947,90,73,17,73,0,71,0,0,0,1,1
3249,135680,1008,Block 1008,35,33.753983,-84.4551244,35,25,10,25,0,25,0,0,0,0,0
3250,135681,1009,Block 1009,55,33.754664,-84.4585324,55,18,37,18,0,16,0,0,0,0,2
3251,135682,1010,Block 1010,171,33.7568076,-84.4593125,171,17,154,17,0,17,0,0,0,0,0
3252,135684,2000,Block 2000,15,33.7625829,-84.4418448,15,13,2,13,0,13,0,0,0,0,0
3253,135685,2001,Block 2001,30,33.7621255,-84.4431538,30,22,8,22,0,22,0,0,0,0,0
3254,135686,2002,Block 2002,33,33.76267,-84.4446802,33,28,5,28,0,28,0,0,0,0,0
3255,135687,2003,Block 2003,88,33.7613212,-84.4477765,88,64,24,64,0,64,0,0,0,0,0
3256,135688,2004,Block 2004,13,33.7637687,-84.4505205,13,5,8,5,1,3,0,0,0,1,0
3257,135689,2005,Block 2005,18,33.760162,-84.4442657,18,13,5,13,0,13,0,0,0,0,0
3258,135690,2006,Block 2006,16,33.7588339,-84.4446777,16,14,2,14,0,14,0,0,0,0,0
3259,135691,2007,Block 2007,55,33.7585879,-84.4485102,55,39,16,39,0,38,0,0,0,0,1
3260,135692,2008,Block 2008,45,33.7561809,-84.4464857,45,39,6,39,1,38,0,0,0,0,0
3261,135693,2009,Block 2009,17,33.7544485,-84.4477514,17,11,6,11,1,10,0,0,0,0,0
3262,135694,2010,Block 2010,3,33.7534586,-84.446705,3,3,0,3,1,2,0,0,0,0,0
3263,135695,2011,Block 2011,29,33.7526741,-84.4495649,29,24,5,24,0,23,0,0,0,0,1
3264,135696,2012,Block 2012,14,33.7523633,-84.4519583,14,12,2,12,0,12,0,0,0,0,0
3265,135697,2013,Block 2013,19,33.7533688,-84.4505406,19,15,4,15,0,15,0,0,0,0,0
3266,135698,2014,Block 2014,27,33.7544435,-84.4501624,27,27,0,27,0,26,1,0,0,0,0
3267,135699,2015,Block 2015,7,33.7542903,-84.451285,7,4,3,4,0,4,0,0,0,0,0
3268,135700,2016,Block 2016,14,33.7535285,-84.4521825,14,13,1,13,0,13,0,0,0,0,0
3269,135701,2017,Block 2017,10,33.7536036,-84.4532479,10,10,0,10,0,10,0,0,0,0,0
3270,135705,1001,Block 1001,238,33.7667121,-84.4300446,238,130,108,130,0,128,0,0,0,1,1
3271,135706,1002,Block 1002,42,33.7672776,-84.4345275,42,26,16,26,1,25,0,0,0,0,0
3272,135707,1003,Block 1003,90,33.7658057,-84.4369328,90,39,51,39,1,37,0,1,0,0,0
3273,135708,1004,Block 1004,43,33.7656052,-84.4340393,43,27,16,27,0,27,0,0,0,0,0
3274,135709,1005,Block 1005,83,33.7645036,-84.4317758,83,25,58,25,1,24,0,0,0,0,0
3275,135710,1006,Block 1006,43,33.7639277,-84.4304394,43,21,22,21,0,21,0,0,0,0,0
3276,135711,1007,Block 1007,73,33.7645118,-84.4290089,73,38,35,38,2,36,0,0,0,0,0
3277,135712,1008,Block 1008,203,33.7644717,-84.426314,203,81,122,81,2,74,0,0,0,0,5
3278,135713,1009,Block 1009,37,33.764135,-84.43465,37,20,17,20,0,20,0,0,0,0,0
3279,135714,1010,Block 1010,2,33.7641827,-84.4355319,2,0,2,0,0,0,0,0,0,0,0
3280,135715,1011,Block 1011,6,33.7644535,-84.4355602,6,3,3,3,0,3,0,0,0,0,0
3281,135717,2000,Block 2000,6,33.7629788,-84.4323376,6,3,3,3,0,3,0,0,0,0,0
3282,135718,2001,Block 2001,5,33.7633224,-84.4348376,5,1,4,1,0,0,0,0,0,1,0
3283,135719,2002,Block 2002,21,33.761679,-84.4328805,21,18,3,18,0,18,0,0,0,0,0
3284,135720,2003,Block 2003,34,33.7626411,-84.4349085,34,17,17,17,1,16,0,0,0,0,0
3285,135721,2004,Block 2004,37,33.7619189,-84.4371269,37,26,11,26,1,24,0,0,0,0,1
3286,135722,2005,Block 2005,17,33.7601918,-84.4329561,17,13,4,13,0,13,0,0,0,0,0
3287,135723,2006,Block 2006,23,33.7607763,-84.4350212,23,18,5,18,0,18,0,0,0,0,0
3288,135724,2007,Block 2007,20,33.7617261,-84.4349858,20,18,2,18,0,18,0,0,0,0,0
3289,135725,2008,Block 2008,34,33.7593129,-84.4362038,34,22,12,22,0,21,0,0,0,0,1
3290,135726,2009,Block 2009,22,33.7592902,-84.434116,22,14,8,14,0,14,0,0,0,0,0
3291,135727,2010,Block 2010,18,33.7588876,-84.433018,18,10,8,10,0,10,0,0,0,0,0
3292,135728,2011,Block 2011,17,33.7588716,-84.4318862,17,14,3,14,0,14,0,0,0,0,0
3293,135729,2012,Block 2012,15,33.760174,-84.4318769,15,11,4,11,0,11,0,0,0,0,0
3294,135730,2013,Block 2013,9,33.7615568,-84.4317748,9,6,3,6,0,6,0,0,0,0,0
3295,135731,2014,Block 2014,8,33.7600887,-84.4310469,8,7,1,7,0,7,0,0,0,0,0
3296,135732,2015,Block 2015,32,33.756796,-84.4327825,32,28,4,28,0,28,0,0,0,0,0
3297,135733,2016,Block 2016,48,33.7578811,-84.4357892,48,32,16,32,1,31,0,0,0,0,0
3298,135734,2017,Block 2017,26,33.7577938,-84.4324162,26,20,6,20,0,19,0,1,0,0,0
3299,135735,2018,Block 2018,46,33.757006,-84.4356926,46,38,8,38,1,37,0,0,0,0,0
3300,135737,3000,Block 3000,141,33.7658057,-84.4386389,141,20,121,20,1,19,0,0,0,0,0
3301,135738,3001,Block 3001,28,33.7670336,-84.4402807,28,14,14,14,0,14,0,0,0,0,0
3302,135739,3002,Block 3002,176,33.7647949,-84.440312,176,111,65,111,1,107,0,0,0,0,3
3303,135740,3003,Block 3003,32,33.7624932,-84.4402114,32,21,11,21,0,19,0,0,0,0,2
3304,135741,3004,Block 3004,58,33.7609995,-84.4391082,58,48,10,48,1,45,0,0,0,0,2
3305,135742,3005,Block 3005,244,33.7570964,-84.4409241,244,210,34,210,3,204,0,0,0,0,3
3306,135743,3006,Block 3006,30,33.7577507,-84.4390186,30,29,1,29,1,28,0,0,0,0,0
3307,135744,3007,Block 3007,10,33.7582935,-84.4383407,10,6,4,6,1,5,0,0,0,0,0
3308,135749,1002,Block 1002,8,33.7739668,-84.4316377,8,6,2,6,0,6,0,0,0,0,0
3309,135750,1003,Block 1003,511,33.7739933,-84.4350494,511,350,161,350,3,336,0,1,0,2,8
3310,135751,1004,Block 1004,5,33.772188,-84.4357379,5,5,0,5,0,5,0,0,0,0,0
3311,135752,1005,Block 1005,13,33.7728893,-84.4362007,13,6,7,6,0,6,0,0,0,0,0
3312,135753,1006,Block 1006,39,33.7697532,-84.4368471,39,35,4,35,1,34,0,0,0,0,0
3313,135754,1007,Block 1007,12,33.7705867,-84.434996,12,10,2,10,0,10,0,0,0,0,0
3314,135755,1008,Block 1008,11,33.7706311,-84.4332897,11,6,5,6,0,6,0,0,0,0,0
3315,135756,1009,Block 1009,34,33.7697524,-84.4319836,34,23,11,23,0,22,0,0,0,1,0
3316,135758,1011,Block 1011,19,33.7689428,-84.4303475,19,11,8,11,0,11,0,0,0,0,0
3317,135765,1018,Block 1018,31,33.7688272,-84.4347746,31,28,3,28,1,27,0,0,0,0,0
3318,135766,1019,Block 1019,13,33.7692501,-84.4332166,13,8,5,8,0,8,0,0,0,0,0
3319,135768,2000,Block 2000,39,33.7697795,-84.4382168,39,21,18,21,0,21,0,0,0,0,0
3320,135769,2001,Block 2001,22,33.7707814,-84.4404409,22,15,7,15,1,14,0,0,0,0,0
3321,135770,2002,Block 2002,33,33.7730752,-84.4438942,33,22,11,22,0,22,0,0,0,0,0
3322,135772,2004,Block 2004,43,33.7725573,-84.4470361,43,36,7,36,3,32,0,1,0,0,0
3323,135773,2005,Block 2005,20,33.770465,-84.4475457,20,15,5,15,0,15,0,0,0,0,0
3324,135774,2006,Block 2006,14,33.7704688,-84.4487082,14,8,6,8,0,8,0,0,0,0,0
3325,135775,2007,Block 2007,17,33.7716578,-84.4495279,17,13,4,13,0,11,0,0,0,1,1
3326,135776,2008,Block 2008,74,33.7732035,-84.4527236,74,56,18,56,0,54,0,0,0,1,1
3327,135777,2009,Block 2009,6,33.769141,-84.4475375,6,3,3,3,0,3,0,0,0,0,0
3328,135778,2010,Block 2010,9,33.7691184,-84.4464216,9,7,2,7,0,7,0,0,0,0,0
3329,135779,2011,Block 2011,8,33.770356,-84.446445,8,7,1,7,0,7,0,0,0,0,0
3330,135780,2012,Block 2012,10,33.7711714,-84.4451968,10,9,1,9,0,9,0,0,0,0,0
3331,135781,2013,Block 2013,14,33.7723464,-84.4452171,14,12,2,12,2,10,0,0,0,0,0
3332,135782,2014,Block 2014,7,33.7713977,-84.443373,7,6,1,6,0,6,0,0,0,0,0
3333,135783,2015,Block 2015,12,33.7698155,-84.4425216,12,10,2,10,0,10,0,0,0,0,0
3334,135784,2016,Block 2016,46,33.7691907,-84.4439202,46,33,13,33,3,30,0,0,0,0,0
3335,135785,2017,Block 2017,8,33.7686983,-84.4399623,8,3,5,3,0,3,0,0,0,0,0
3336,135786,2018,Block 2018,29,33.7705245,-84.4543972,29,16,13,16,0,16,0,0,0,0,0
3337,135787,2019,Block 2019,14,33.7691317,-84.4486842,14,8,6,8,1,7,0,0,0,0,0
3338,135788,2020,Block 2020,14,33.769145,-84.4498564,14,10,4,10,0,10,0,0,0,0,0
3339,135789,2021,Block 2021,13,33.7703981,-84.4498135,13,10,3,10,0,10,0,0,0,0,0
3340,135790,2022,Block 2022,7,33.7702286,-84.4508981,7,7,0,7,0,7,0,0,0,0,0
3341,135791,2023,Block 2023,18,33.7693597,-84.4520342,18,13,5,13,0,13,0,0,0,0,0
3342,135792,2024,Block 2024,39,33.7693919,-84.4543146,39,29,10,29,1,28,0,0,0,0,0
3343,135793,2025,Block 2025,14,33.7691538,-84.4509594,14,9,5,9,0,8,0,0,0,0,1
3344,135795,3000,Block 3000,8,33.7882303,-84.4548353,8,5,3,5,0,5,0,0,0,0,0
3345,135796,3001,Block 3001,15,33.7865556,-84.4523619,15,3,12,3,0,3,0,0,0,0,0
3346,135797,3002,Block 3002,16,33.7857345,-84.4528318,16,11,5,11,0,10,0,0,0,0,1
3347,135798,3003,Block 3003,36,33.7853556,-84.4514312,36,22,14,22,3,19,0,0,0,0,0
3348,135799,3004,Block 3004,70,33.7843809,-84.4543352,70,32,38,32,2,30,0,0,0,0,0
3349,135800,3005,Block 3005,22,33.7844285,-84.4562795,22,16,6,16,0,16,0,0,0,0,0
3350,135801,3006,Block 3006,5,33.7824842,-84.4561414,5,0,5,0,0,0,0,0,0,0,0
3351,135802,3007,Block 3007,1,33.7825061,-84.4570895,1,1,0,1,0,0,0,0,0,0,1
3352,135803,3008,Block 3008,16,33.780677,-84.4560822,16,8,8,8,0,8,0,0,0,0,0
3353,135804,3009,Block 3009,18,33.7817217,-84.4551956,18,11,7,11,0,11,0,0,0,0,0
3354,135805,3010,Block 3010,29,33.782354,-84.4534212,29,22,7,22,0,22,0,0,0,0,0
3355,135806,3011,Block 3011,15,33.7820222,-84.447205,15,10,5,10,1,9,0,0,0,0,0
3356,135807,3012,Block 3012,7,33.7812047,-84.4496714,7,5,2,5,0,5,0,0,0,0,0
3357,135808,3013,Block 3013,4,33.7820346,-84.4510451,4,0,4,0,0,0,0,0,0,0,0
3358,135809,3014,Block 3014,12,33.7802824,-84.4474321,12,9,3,9,0,9,0,0,0,0,0
3359,135810,3015,Block 3015,50,33.7804876,-84.453431,50,26,24,26,0,25,0,0,0,1,0
3360,135811,3016,Block 3016,9,33.7806537,-84.451541,9,5,4,5,0,5,0,0,0,0,0
3361,135812,3017,Block 3017,10,33.7803013,-84.4496776,10,8,2,8,1,7,0,0,0,0,0
3362,135813,3018,Block 3018,13,33.7788527,-84.4504662,13,11,2,11,0,11,0,0,0,0,0
3363,135814,3019,Block 3019,6,33.7788679,-84.4522043,6,6,0,6,0,6,0,0,0,0,0
3364,135816,3021,Block 3021,17,33.7773702,-84.4545247,17,14,3,14,0,14,0,0,0,0,0
3365,135817,3022,Block 3022,30,33.7786719,-84.4555768,30,24,6,24,0,24,0,0,0,0,0
3366,135818,3023,Block 3023,18,33.7784575,-84.4485201,18,10,8,10,0,10,0,0,0,0,0
3367,135819,3024,Block 3024,39,33.7776845,-84.4440208,39,31,8,31,1,29,0,0,0,1,0
3368,135820,3025,Block 3025,1,33.7764244,-84.4445022,1,1,0,1,1,0,0,0,0,0,0
3369,135821,3026,Block 3026,17,33.7751731,-84.4451784,17,13,4,13,1,12,0,0,0,0,0
3370,135823,3028,Block 3028,16,33.7749239,-84.4437936,16,8,8,8,0,8,0,0,0,0,0
3371,135825,3030,Block 3030,32,33.7745023,-84.4424662,32,26,6,26,2,23,0,0,0,0,1
3372,135826,3031,Block 3031,13,33.7738968,-84.4395443,13,7,6,7,1,6,0,0,0,0,0
3373,135827,3032,Block 3032,21,33.7738663,-84.4414054,21,13,8,13,2,11,0,0,0,0,0
3374,135828,3033,Block 3033,19,33.7765985,-84.4474073,19,11,8,11,1,10,0,0,0,0,0
3375,135829,3034,Block 3034,26,33.7777199,-84.4476803,26,20,6,20,3,16,0,0,0,0,1
3376,135830,3035,Block 3035,40,33.7742831,-84.4493985,40,33,7,33,0,33,0,0,0,0,0
3377,135831,3036,Block 3036,46,33.7744502,-84.4515521,46,33,13,33,0,33,0,0,0,0,0
3378,135833,3038,Block 3038,15,33.7752972,-84.4466087,15,12,3,12,0,12,0,0,0,0,0
3379,135837,1001,Block 1001,384,33.7891718,-84.4735556,384,370,14,370,3,363,0,0,0,0,4
3380,135838,1002,Block 1002,8,33.7874297,-84.4716836,8,8,0,8,0,7,0,0,0,0,1
3381,135841,1005,Block 1005,1,33.7916155,-84.4656263,1,1,0,1,0,1,0,0,0,0,0
3382,135843,1007,Block 1007,5,33.7899138,-84.4619339,5,4,1,4,0,3,1,0,0,0,0
3383,135844,1008,Block 1008,215,33.7861643,-84.459556,215,173,42,173,1,171,0,0,0,0,1
3384,135845,1009,Block 1009,15,33.787816,-84.4698012,15,12,3,12,0,12,0,0,0,0,0
3385,135846,1010,Block 1010,13,33.7893783,-84.4684023,13,9,4,9,0,8,0,0,0,1,0
3386,135847,1011,Block 1011,4,33.7900338,-84.4681816,4,4,0,4,0,4,0,0,0,0,0
3387,135848,1012,Block 1012,2,33.7886794,-84.4675102,2,2,0,2,0,2,0,0,0,0,0
3388,135851,2000,Block 2000,7,33.7871397,-84.4675153,7,5,2,5,0,5,0,0,0,0,0
3389,135852,2001,Block 2001,13,33.7866431,-84.4693212,13,6,7,6,0,6,0,0,0,0,0
3390,135853,2002,Block 2002,30,33.7839887,-84.4672745,30,20,10,20,0,20,0,0,0,0,0
3391,135854,2003,Block 2003,3,33.7853671,-84.4686945,3,2,1,2,0,2,0,0,0,0,0
3392,135855,2004,Block 2004,7,33.7853727,-84.4698381,7,3,4,3,0,2,0,1,0,0,0
3393,135856,2005,Block 2005,4,33.7853816,-84.4709757,4,3,1,3,0,3,0,0,0,0,0
3394,135857,2006,Block 2006,3,33.7853483,-84.4722425,3,2,1,2,0,2,0,0,0,0,0
3395,135858,2007,Block 2007,2,33.7861975,-84.4719766,2,0,2,0,0,0,0,0,0,0,0
3396,135859,2008,Block 2008,2,33.7838637,-84.4693235,2,1,1,1,0,1,0,0,0,0,0
3397,135860,2009,Block 2009,11,33.783827,-84.4709806,11,10,1,10,1,9,0,0,0,0,0
3398,135861,2010,Block 2010,1,33.7844117,-84.4721348,1,1,0,1,0,1,0,0,0,0,0
3399,135863,2012,Block 2012,3,33.7854803,-84.4731826,3,2,1,2,0,2,0,0,0,0,0
3400,135865,2014,Block 2014,14,33.7848948,-84.4748696,14,10,4,10,1,9,0,0,0,0,0
3401,135867,2016,Block 2016,9,33.7855953,-84.4762292,9,4,5,4,0,4,0,0,0,0,0
3402,135868,2017,Block 2017,5,33.7837059,-84.4755018,5,5,0,5,0,5,0,0,0,0,0
3403,135869,2018,Block 2018,5,33.7832358,-84.4739367,5,2,3,2,0,2,0,0,0,0,0
3404,135870,2019,Block 2019,7,33.7834474,-84.472616,7,1,6,1,0,1,0,0,0,0,0
3405,135871,2020,Block 2020,78,33.7791898,-84.4716523,78,56,22,56,2,53,1,0,0,0,0
3406,135874,2023,Block 2023,18,33.7779172,-84.4733912,18,0,18,0,0,0,0,0,0,0,0
3407,135875,2024,Block 2024,84,33.7809877,-84.4754032,84,14,70,14,0,14,0,0,0,0,0
3408,135876,2025,Block 2025,12,33.7829453,-84.4754742,12,8,4,8,0,8,0,0,0,0,0
3409,135877,2026,Block 2026,5,33.7761663,-84.4686013,5,3,2,3,0,3,0,0,0,0,0
3410,135878,2027,Block 2027,22,33.7767132,-84.4669234,22,12,10,12,0,12,0,0,0,0,0
3411,135879,2028,Block 2028,64,33.7803624,-84.4677918,64,43,21,43,0,41,0,0,0,0,2
3412,135880,2029,Block 2029,13,33.7783349,-84.4663863,13,11,2,11,0,11,0,0,0,0,0
3413,135881,2030,Block 2030,7,33.7757745,-84.4704037,7,2,5,2,0,2,0,0,0,0,0
3414,135883,3000,Block 3000,13,33.7753723,-84.4548965,13,11,2,11,0,11,0,0,0,0,0
3415,135884,3001,Block 3001,109,33.773353,-84.4567267,109,78,31,78,1,76,1,0,0,0,0
3416,135885,3002,Block 3002,20,33.7733117,-84.4585112,20,17,3,17,0,17,0,0,0,0,0
3417,135886,3003,Block 3003,63,33.7739771,-84.4600449,63,53,10,53,1,51,1,0,0,0,0
3418,135887,3004,Block 3004,74,33.772912,-84.4624115,74,49,25,49,0,49,0,0,0,0,0
3419,135888,3005,Block 3005,22,33.7754001,-84.4633436,22,13,9,13,0,13,0,0,0,0,0
3420,135889,3006,Block 3006,26,33.7747828,-84.4644605,26,15,11,15,0,15,0,0,0,0,0
3421,135890,3007,Block 3007,84,33.7734867,-84.4662136,84,60,24,60,0,60,0,0,0,0,0
3422,135891,3008,Block 3008,51,33.7726068,-84.4677716,51,39,12,39,0,39,0,0,0,0,0
3423,135892,3009,Block 3009,17,33.7736998,-84.4700839,17,15,2,15,0,15,0,0,0,0,0
3424,135893,3010,Block 3010,4,33.7754023,-84.4728741,4,3,1,3,0,3,0,0,0,0,0
3425,135894,3011,Block 3011,3,33.7744481,-84.4723718,3,3,0,3,0,2,0,0,0,0,1
3426,135895,3012,Block 3012,10,33.7722641,-84.469068,10,8,2,8,0,8,0,0,0,0,0
3427,135896,3013,Block 3013,36,33.7706251,-84.4691898,36,32,4,32,0,32,0,0,0,0,0
3428,135897,3014,Block 3014,23,33.7706056,-84.470772,23,17,6,17,0,16,1,0,0,0,0
3429,135898,3015,Block 3015,27,33.7707029,-84.472263,27,22,5,22,0,22,0,0,0,0,0
3430,135899,3016,Block 3016,17,33.772833,-84.4729561,17,11,6,11,0,11,0,0,0,0,0
3431,135900,3017,Block 3017,23,33.7728274,-84.4718223,23,20,3,20,0,20,0,0,0,0,0
3432,135901,3018,Block 3018,50,33.7713814,-84.4649081,50,42,8,42,0,42,0,0,0,0,0
3433,135902,3019,Block 3019,15,33.7707109,-84.4600447,15,14,1,14,0,14,0,0,0,0,0
3434,135904,4000,Block 4000,25,33.7872206,-84.4655855,25,15,10,15,0,15,0,0,0,0,0
3435,135906,4002,Block 4002,25,33.7832796,-84.4649097,25,14,11,14,0,14,0,0,0,0,0
3436,135907,4003,Block 4003,8,33.7852393,-84.46459,8,6,2,6,0,6,0,0,0,0,0
3437,135908,4004,Block 4004,17,33.7860328,-84.4656796,17,14,3,14,0,13,0,1,0,0,0
3438,135909,4005,Block 4005,17,33.78474,-84.4662035,17,6,11,6,0,6,0,0,0,0,0
3439,135910,4006,Block 4006,111,33.7824275,-84.4626696,111,59,52,59,2,57,0,0,0,0,0
3440,135911,4007,Block 4007,18,33.7796752,-84.4595068,18,10,8,10,0,10,0,0,0,0,0
3441,135912,4008,Block 4008,11,33.7803623,-84.4630682,11,6,5,6,0,6,0,0,0,0,0
3442,135913,4009,Block 4009,23,33.7785046,-84.4636165,23,16,7,16,0,16,0,0,0,0,0
3443,135914,4010,Block 4010,17,33.7794847,-84.4649134,17,13,4,13,0,13,0,0,0,0,0
3444,135915,4011,Block 4011,78,33.777798,-84.4650373,78,72,6,72,0,72,0,0,0,0,0
3445,135916,4012,Block 4012,23,33.7785888,-84.4627396,23,13,10,13,0,13,0,0,0,0,0
3446,135917,4013,Block 4013,29,33.7783548,-84.4570776,29,17,12,17,0,17,0,0,0,0,0
3447,135920,1000,Block 1000,346,33.7944688,-84.4806314,346,303,43,303,23,270,0,4,0,2,4
3448,135921,1001,Block 1001,29,33.7953632,-84.4814785,29,25,4,25,0,25,0,0,0,0,0
3449,135923,1003,Block 1003,24,33.7862589,-84.4820431,24,22,2,22,1,21,0,0,0,0,0
3450,135933,2003,Block 2003,12,33.7991182,-84.4965316,12,11,1,11,0,10,0,0,0,0,1
3451,135939,2009,Block 2009,8,33.7900309,-84.4944492,8,4,4,4,0,4,0,0,0,0,0
3452,135940,2010,Block 2010,53,33.7932342,-84.4915448,53,46,7,46,4,41,0,0,0,1,0
3453,135941,2011,Block 2011,38,33.7928831,-84.4901312,38,32,6,32,0,32,0,0,0,0,0
3454,135946,2016,Block 2016,53,33.7909876,-84.4876875,53,46,7,46,1,44,0,0,0,0,1
3455,135954,1001,Block 1001,119,33.8060899,-84.4639461,119,81,38,81,1,72,0,1,0,4,3
3456,135956,1003,Block 1003,46,33.8037156,-84.4625702,46,29,17,29,0,29,0,0,0,0,0
3457,135957,1004,Block 1004,17,33.8045365,-84.466236,17,14,3,14,0,14,0,0,0,0,0
3458,135958,1005,Block 1005,8,33.8055375,-84.4686971,8,7,1,7,1,6,0,0,0,0,0
3459,135959,1006,Block 1006,20,33.8048046,-84.4733565,20,19,1,19,1,18,0,0,0,0,0
3460,135961,1008,Block 1008,1,33.8050126,-84.485345,1,1,0,1,1,0,0,0,0,0,0
3461,135962,1009,Block 1009,13,33.8031975,-84.4833335,13,6,7,6,2,4,0,0,0,0,0
3462,135964,1013,Block 1013,2,33.8027133,-84.475247,2,2,0,2,0,2,0,0,0,0,0
3463,135965,1014,Block 1014,19,33.8035647,-84.4789369,19,16,3,16,0,16,0,0,0,0,0
3464,135966,1015,Block 1015,26,33.8018863,-84.4831413,26,20,6,20,0,20,0,0,0,0,0
3465,135970,1019,Block 1019,25,33.801147,-84.4820739,25,22,3,22,0,22,0,0,0,0,0
3466,135971,1020,Block 1020,13,33.8003169,-84.4844055,13,11,2,11,0,11,0,0,0,0,0
3467,135972,1021,Block 1021,19,33.801752,-84.4607397,19,17,2,17,0,17,0,0,0,0,0
3468,135973,1022,Block 1022,8,33.8016149,-84.4626101,8,5,3,5,0,5,0,0,0,0,0
3469,135974,1023,Block 1023,14,33.8016358,-84.4640646,14,10,4,10,0,10,0,0,0,0,0
3470,135975,1024,Block 1024,13,33.80402,-84.4678675,13,10,3,10,2,8,0,0,0,0,0
3471,135976,1025,Block 1025,13,33.8046941,-84.467878,13,5,8,5,0,5,0,0,0,0,0
3472,135977,1026,Block 1026,4,33.8042849,-84.4695128,4,4,0,4,0,4,0,0,0,0,0
3473,135980,1029,Block 1029,9,33.8020847,-84.4847231,9,3,6,3,0,3,0,0,0,0,0
3474,135981,1030,Block 1030,10,33.8008924,-84.457229,10,10,0,10,0,10,0,0,0,0,0
3475,135983,2000,Block 2000,34,33.800619,-84.4599581,34,27,7,27,4,23,0,0,0,0,0
3476,135984,2001,Block 2001,32,33.8009111,-84.4640662,32,27,5,27,0,27,0,0,0,0,0
3477,135985,2002,Block 2002,214,33.8014294,-84.4681342,214,175,39,175,1,172,0,0,0,0,2
3478,135986,2003,Block 2003,20,33.8031642,-84.4676668,20,16,4,16,1,14,0,0,0,0,1
3479,135987,2004,Block 2004,88,33.7982965,-84.4645284,88,69,19,69,0,66,0,0,0,3,0
3480,135989,2006,Block 2006,21,33.7986063,-84.4662829,21,20,1,20,0,20,0,0,0,0,0
3481,135990,2007,Block 2007,29,33.7995786,-84.4598459,29,22,7,22,0,22,0,0,0,0,0
3482,135991,2008,Block 2008,7,33.7937298,-84.4596065,7,5,2,5,0,5,0,0,0,0,0
3483,135996,3000,Block 3000,165,33.7999786,-84.4727815,165,131,34,131,2,126,1,0,0,0,2
3484,135997,3001,Block 3001,18,33.7969487,-84.4703539,18,0,18,0,0,0,0,0,0,0,0
3485,136000,3004,Block 3004,99,33.7993767,-84.4762154,99,88,11,88,5,81,1,0,0,0,1
3486,136001,3005,Block 3005,42,33.8010415,-84.4784176,42,37,5,37,0,37,0,0,0,0,0
3487,136002,3006,Block 3006,29,33.8001839,-84.4799753,29,23,6,23,0,23,0,0,0,0,0
3488,136003,3007,Block 3007,66,33.7992895,-84.4822795,66,44,22,44,0,44,0,0,0,0,0
3489,136004,3008,Block 3008,17,33.799822,-84.4813407,17,14,3,14,0,14,0,0,0,0,0
3490,136007,3011,Block 3011,12,33.7998763,-84.4775695,12,5,7,5,0,5,0,0,0,0,0
3491,136008,3012,Block 3012,7,33.799181,-84.4774253,7,6,1,6,0,5,0,0,0,0,1
3492,136010,3014,Block 3014,21,33.7962353,-84.4781434,21,18,3,18,0,18,0,0,0,0,0
3493,136011,3015,Block 3015,16,33.7964301,-84.475691,16,11,5,11,0,11,0,0,0,0,0
3494,136015,4002,Block 4002,415,33.7939108,-84.4494789,415,381,34,381,21,338,2,7,0,2,11
3495,136016,4003,Block 4003,31,33.7964854,-84.4550138,31,25,6,25,0,24,0,0,0,0,1
3496,136017,4004,Block 4004,27,33.7912209,-84.4459253,27,25,2,25,0,23,0,0,0,0,2
3497,136018,4005,Block 4005,259,33.7887475,-84.4492693,259,210,49,210,29,173,0,2,0,0,6
3498,136019,4006,Block 4006,6,33.7920498,-84.4485275,6,6,0,6,0,5,0,0,0,1,0
3499,136024,4011,Block 4011,134,33.7860032,-84.4456215,134,128,6,128,1,125,0,0,0,0,2
3500,136025,4012,Block 4012,15,33.7882094,-84.4420344,15,12,3,12,5,7,0,0,0,0,0
3501,136030,4017,Block 4017,5,33.782154,-84.4439453,5,4,1,4,0,4,0,0,0,0,0
3502,136031,4018,Block 4018,8,33.7775725,-84.4390233,8,8,0,8,1,7,0,0,0,0,0
3503,136032,4019,Block 4019,7,33.7761417,-84.4390959,7,7,0,7,1,6,0,0,0,0,0
3504,136033,4020,Block 4020,1,33.7871139,-84.4462127,1,1,0,1,0,1,0,0,0,0,0
3505,136042,1002,Block 1002,15,33.8205976,-84.4609278,15,7,8,7,2,5,0,0,0,0,0
3506,136043,1003,Block 1003,142,33.8177842,-84.4523093,142,129,13,129,55,65,0,3,0,5,1
3507,136044,1004,Block 1004,64,33.8187631,-84.4574294,64,59,5,59,54,5,0,0,0,0,0
3508,136045,1005,Block 1005,8,33.8179487,-84.4572555,8,7,1,7,5,1,0,0,0,0,1
3509,136047,1007,Block 1007,64,33.8074092,-84.4524217,64,54,10,54,30,23,0,1,0,0,0
3510,136049,1009,Block 1009,36,33.8149697,-84.4571855,36,34,2,34,29,2,0,1,0,1,1
3511,136050,1010,Block 1010,2,33.8021318,-84.4431596,2,2,0,2,2,0,0,0,0,0,0
3512,136051,1011,Block 1011,20,33.8032486,-84.4446532,20,16,4,16,11,4,0,1,0,0,0
3513,136052,1012,Block 1012,154,33.8116437,-84.4499531,154,144,10,144,127,10,0,1,0,3,3
3514,136055,1015,Block 1015,11,33.8033224,-84.4457589,11,9,2,9,7,0,0,1,0,0,1
3515,136056,1016,Block 1016,10,33.812597,-84.4558932,10,10,0,10,9,1,0,0,0,0,0
3516,136057,1017,Block 1017,130,33.81826,-84.4606515,130,130,0,130,8,119,0,0,2,0,1
3517,136058,1018,Block 1018,16,33.8172888,-84.4637096,16,16,0,16,15,0,0,1,0,0,0
3518,136059,1019,Block 1019,5,33.8170245,-84.463686,5,5,0,5,5,0,0,0,0,0,0
3519,136060,1020,Block 1020,29,33.8016844,-84.4401686,29,24,5,24,22,2,0,0,0,0,0
3520,136061,1021,Block 1021,27,33.8078464,-84.4419926,27,25,2,25,23,2,0,0,0,0,0
3521,136065,1025,Block 1025,13,33.8163826,-84.4480978,13,10,3,10,5,3,2,0,0,0,0
3522,136066,1026,Block 1026,22,33.8151598,-84.4478158,22,22,0,22,19,1,0,1,0,1,0
3523,136068,1028,Block 1028,5,33.8098098,-84.4500012,5,4,1,4,3,0,0,1,0,0,0
3524,136069,1029,Block 1029,2,33.8089506,-84.4514795,2,2,0,2,2,0,0,0,0,0,0
3525,136070,1030,Block 1030,3,33.8090843,-84.448157,3,3,0,3,3,0,0,0,0,0,0
3526,136071,1031,Block 1031,37,33.8070857,-84.4496027,37,31,6,31,26,4,0,1,0,0,0
3527,136072,1032,Block 1032,5,33.8092275,-84.4474322,5,4,1,4,4,0,0,0,0,0,0
3528,136073,1033,Block 1033,6,33.8072607,-84.4474488,6,6,0,6,6,0,0,0,0,0,0
3529,136074,1034,Block 1034,30,33.8152138,-84.4513298,30,25,5,25,18,5,0,0,0,1,1
3530,136075,1035,Block 1035,8,33.8085423,-84.447572,8,8,0,8,8,0,0,0,0,0,0
3531,136076,1036,Block 1036,15,33.8112378,-84.4482688,15,15,0,15,15,0,0,0,0,0,0
3532,136078,1038,Block 1038,24,33.8103082,-84.4493158,24,24,0,24,19,5,0,0,0,0,0
3533,136079,1039,Block 1039,15,33.8084038,-84.4495784,15,15,0,15,11,3,0,1,0,0,0
3534,136080,1040,Block 1040,24,33.8084974,-84.4488972,24,24,0,24,16,3,0,2,0,0,3
3535,136081,1041,Block 1041,1,33.8066327,-84.4474009,1,1,0,1,0,0,0,0,0,0,1
3536,136082,1042,Block 1042,29,33.8144279,-84.4554839,29,28,1,28,25,2,0,1,0,0,0
3537,136083,1043,Block 1043,12,33.8127756,-84.45527,12,11,1,11,11,0,0,0,0,0,0
3538,136085,1045,Block 1045,2,33.8034608,-84.43787,2,2,0,2,0,1,0,0,0,0,1
3539,136089,1049,Block 1049,3,33.7939689,-84.4373197,3,1,2,1,0,1,0,0,0,0,0
3540,136093,1053,Block 1053,16,33.8100498,-84.4582428,16,15,1,15,13,2,0,0,0,0,0
3541,136095,1055,Block 1055,2,33.8169325,-84.4634134,2,2,0,2,2,0,0,0,0,0,0
3542,136096,1056,Block 1056,3,33.8165322,-84.4633641,3,3,0,3,3,0,0,0,0,0,0
3543,136097,1057,Block 1057,1,33.8163088,-84.4636903,1,1,0,1,0,0,0,1,0,0,0
3544,136098,1058,Block 1058,269,33.8103791,-84.4636007,269,188,81,188,93,73,0,4,0,10,8
3545,136100,1060,Block 1060,10,33.8071244,-84.4675965,10,4,6,4,0,3,0,0,0,1,0
3546,136101,1061,Block 1061,19,33.8115625,-84.4666411,19,16,3,16,5,11,0,0,0,0,0
3547,136102,1062,Block 1062,17,33.8109264,-84.4674898,17,16,1,16,6,10,0,0,0,0,0
3548,136112,1072,Block 1072,29,33.8162145,-84.4574455,29,28,1,28,26,2,0,0,0,0,0
3549,136113,1073,Block 1073,8,33.8086672,-84.4700259,8,8,0,8,3,5,0,0,0,0,0
3550,136114,1074,Block 1074,8,33.8081708,-84.4711469,8,6,2,6,4,2,0,0,0,0,0
3551,136115,1075,Block 1075,1,33.8068205,-84.4698821,1,0,1,0,0,0,0,0,0,0,0
3552,136116,1076,Block 1076,21,33.8034534,-84.4435103,21,19,2,19,16,3,0,0,0,0,0
3553,136119,1079,Block 1079,7,33.8093722,-84.4488578,7,7,0,7,7,0,0,0,0,0,0
3554,136120,1080,Block 1080,9,33.8101444,-84.4484485,9,8,1,8,8,0,0,0,0,0,0
3555,136121,1081,Block 1081,8,33.8104741,-84.448014,8,8,0,8,7,1,0,0,0,0,0
3556,136122,1082,Block 1082,11,33.8101878,-84.4488588,11,11,0,11,10,1,0,0,0,0,0
3557,136126,2001,Block 2001,30,33.8211543,-84.4691566,30,23,7,23,13,6,0,0,0,4,0
3558,136127,2002,Block 2002,28,33.8205357,-84.473148,28,24,4,24,16,5,0,1,0,2,0
3559,136128,2003,Block 2003,18,33.8188679,-84.4731278,18,16,2,16,13,3,0,0,0,0,0
3560,136129,2004,Block 2004,57,33.8183318,-84.4712647,57,54,3,54,40,13,0,1,0,0,0
3561,136130,2005,Block 2005,27,33.8168312,-84.4729638,27,25,2,25,19,5,0,1,0,0,0
3562,136131,2006,Block 2006,14,33.8168126,-84.4696231,14,12,2,12,9,2,0,1,0,0,0
3563,136132,2007,Block 2007,16,33.8148016,-84.4757326,16,14,2,14,8,5,1,0,0,0,0
3564,136133,2008,Block 2008,55,33.8155865,-84.4737287,55,52,3,52,44,8,0,0,0,0,0
3565,136134,2009,Block 2009,25,33.8149207,-84.4708523,25,20,5,20,15,4,1,0,0,0,0
3566,136135,2010,Block 2010,14,33.815278,-84.4686771,14,14,0,14,10,3,0,0,0,1,0
3567,136136,2011,Block 2011,17,33.8138956,-84.4701926,17,14,3,14,9,4,0,0,0,1,0
3568,136137,2012,Block 2012,13,33.8132159,-84.4722503,13,10,3,10,6,2,0,0,0,2,0
3569,136138,2013,Block 2013,7,33.8129732,-84.4699478,7,4,3,4,4,0,0,0,0,0,0
3570,136139,2014,Block 2014,1,33.8120681,-84.4714894,1,1,0,1,0,0,0,1,0,0,0
3571,136140,2015,Block 2015,25,33.8109835,-84.4742808,25,22,3,22,11,7,0,0,0,4,0
3572,136141,2016,Block 2016,24,33.8120488,-84.4748108,24,19,5,19,7,7,0,0,0,5,0
3573,136142,2017,Block 2017,17,33.8130559,-84.4753191,17,12,5,12,10,1,1,0,0,0,0
3574,136143,2018,Block 2018,20,33.8140185,-84.4754072,20,18,2,18,14,3,0,0,0,1,0
3575,136144,2019,Block 2019,25,33.8137157,-84.4781159,25,21,4,21,11,8,0,1,0,0,1
3576,136145,2020,Block 2020,9,33.8136837,-84.4802457,9,9,0,9,5,4,0,0,0,0,0
3577,136146,2021,Block 2021,87,33.8125265,-84.4832663,87,80,7,80,69,8,0,3,0,0,0
3578,136147,2022,Block 2022,12,33.8096304,-84.4825903,12,11,1,11,10,0,0,0,0,0,1
3579,136148,2023,Block 2023,19,33.8091824,-84.4841193,19,15,4,15,14,0,0,0,0,0,1
3580,136149,2024,Block 2024,16,33.8102425,-84.4841744,16,12,4,12,12,0,0,0,0,0,0
3581,136150,2025,Block 2025,7,33.8105467,-84.482937,7,6,1,6,5,1,0,0,0,0,0
3582,136151,2026,Block 2026,55,33.8118539,-84.479641,55,49,6,49,39,8,0,1,0,0,1
3583,136153,2028,Block 2028,1,33.8096582,-84.479599,1,1,0,1,0,1,0,0,0,0,0
3584,136154,2029,Block 2029,24,33.81212,-84.4773695,24,24,0,24,18,4,0,2,0,0,0
3585,136156,2031,Block 2031,70,33.809836,-84.4736629,70,28,42,28,14,8,0,0,0,6,0
3586,136157,2032,Block 2032,39,33.8127407,-84.4795606,39,37,2,37,19,12,0,5,0,0,1
3587,136158,2033,Block 2033,17,33.8086591,-84.4815361,17,14,3,14,14,0,0,0,0,0,0
3588,136159,2034,Block 2034,13,33.8074025,-84.4834608,13,12,1,12,10,1,0,0,0,0,1
3589,136162,2037,Block 2037,18,33.808405,-84.4744807,18,13,5,13,7,6,0,0,0,0,0
3590,136163,2038,Block 2038,9,33.8087515,-84.4724765,9,6,3,6,1,5,0,0,0,0,0
3591,136164,2039,Block 2039,8,33.8070292,-84.4734714,8,7,1,7,7,0,0,0,0,0,0
3592,136167,1000,Block 1000,233,33.809943,-84.4278892,233,217,16,217,136,64,0,11,1,2,3
3593,136168,1001,Block 1001,9,33.8088214,-84.4265248,9,9,0,9,8,1,0,0,0,0,0
3594,136169,1002,Block 1002,17,33.807583,-84.4257777,17,16,1,16,12,4,0,0,0,0,0
3595,136176,1009,Block 1009,27,33.8045397,-84.4350535,27,25,2,25,20,2,0,3,0,0,0
3596,136178,1011,Block 1011,114,33.7975706,-84.4306351,114,80,34,80,57,13,1,5,0,3,1
3597,136179,1012,Block 1012,16,33.792864,-84.4289021,16,15,1,15,12,3,0,0,0,0,0
3598,136181,1014,Block 1014,25,33.7926495,-84.4283992,25,24,1,24,13,5,0,6,0,0,0
3599,136182,1015,Block 1015,15,33.7921933,-84.4288028,15,15,0,15,10,2,0,1,1,0,1
3600,136185,1018,Block 1018,29,33.7913722,-84.4288992,29,26,3,26,19,3,0,2,0,0,2
3601,136187,1020,Block 1020,14,33.7916377,-84.4288641,14,11,3,11,7,3,0,1,0,0,0
3602,136188,1021,Block 1021,15,33.792081,-84.4279515,15,14,1,14,10,1,0,3,0,0,0
3603,136189,1022,Block 1022,22,33.7927593,-84.4277836,22,22,0,22,13,6,0,2,0,1,0
3604,136190,1023,Block 1023,340,33.7946413,-84.4233071,340,121,219,121,39,70,0,6,1,0,5
3605,136191,1024,Block 1024,1,33.7908322,-84.4213804,1,1,0,1,0,1,0,0,0,0,0
3606,136192,1025,Block 1025,1,33.8006572,-84.4256869,1,1,0,1,0,1,0,0,0,0,0
3607,136193,1026,Block 1026,2,33.7908517,-84.4199465,2,1,1,1,1,0,0,0,0,0,0
3608,136196,1029,Block 1029,24,33.8041757,-84.4245628,24,23,1,23,19,3,0,1,0,0,0
3609,136197,1030,Block 1030,18,33.8042073,-84.422311,18,16,2,16,14,0,0,2,0,0,0
3610,136198,1031,Block 1031,33,33.8035671,-84.4232753,33,31,2,31,25,2,0,3,0,0,1
3611,136199,1032,Block 1032,2,33.7881203,-84.4229555,2,2,0,2,0,2,0,0,0,0,0
3612,136201,1034,Block 1034,27,33.789594,-84.4271309,27,6,21,6,2,3,0,1,0,0,0
3613,136202,1035,Block 1035,11,33.8018199,-84.4213776,11,11,0,11,8,3,0,0,0,0,0
3614,136203,1036,Block 1036,2,33.7981077,-84.4191805,2,2,0,2,1,1,0,0,0,0,0
3615,136204,1037,Block 1037,1,33.7957263,-84.4166525,1,0,1,0,0,0,0,0,0,0,0
3616,136205,1038,Block 1038,26,33.7965326,-84.4171428,26,23,3,23,17,4,0,2,0,0,0
3617,136207,1040,Block 1040,1,33.8004765,-84.4185227,1,0,1,0,0,0,0,0,0,0,0
3618,136208,1041,Block 1041,5,33.792512,-84.4280458,5,5,0,5,3,2,0,0,0,0,0
3619,136216,2006,Block 2006,216,33.7995424,-84.4050108,216,207,9,207,57,99,0,38,0,3,10
3620,136217,2007,Block 2007,417,33.7987298,-84.4017162,417,322,95,322,124,90,1,93,1,7,6
3621,136218,2008,Block 2008,29,33.7988396,-84.4001957,29,28,1,28,28,0,0,0,0,0,0
3622,136219,2009,Block 2009,49,33.7967155,-84.3988072,49,47,2,47,42,1,0,0,0,0,4
3623,136220,2010,Block 2010,1,33.7986174,-84.3983542,1,1,0,1,0,0,0,1,0,0,0
3624,136221,2011,Block 2011,37,33.7977293,-84.3991194,37,37,0,37,36,0,0,0,0,1,0
3625,136225,2015,Block 2015,41,33.7966257,-84.4034578,41,37,4,37,35,2,0,0,0,0,0
3626,136227,3000,Block 3000,277,33.7954981,-84.39839,277,230,47,230,87,124,0,6,0,5,8
3627,136228,3001,Block 3001,15,33.7954588,-84.4004587,15,14,1,14,11,3,0,0,0,0,0
3628,136229,3002,Block 3002,14,33.7954423,-84.4016622,14,13,1,13,12,0,0,0,0,0,1
3629,136230,3003,Block 3003,19,33.7954431,-84.4027748,19,18,1,18,17,1,0,0,0,0,0
3630,136231,3004,Block 3004,21,33.7954078,-84.4038992,21,21,0,21,20,0,0,1,0,0,0
3631,136232,3005,Block 3005,24,33.7953091,-84.4050117,24,24,0,24,17,5,0,1,0,1,0
3632,136233,3006,Block 3006,9,33.7951584,-84.4067437,9,9,0,9,5,1,0,2,0,0,1
3633,136234,3007,Block 3007,3,33.7947584,-84.4107374,3,2,1,2,2,0,0,0,0,0,0
3634,136235,3008,Block 3008,2,33.7925889,-84.4089259,2,1,1,1,0,0,0,0,0,0,1
3635,136237,3010,Block 3010,4,33.7970987,-84.4116618,4,4,0,4,4,0,0,0,0,0,0
3636,136238,3011,Block 3011,10,33.7974336,-84.4122273,10,10,0,10,7,1,0,1,0,1,0
3637,136239,3012,Block 3012,14,33.7987201,-84.4103109,14,13,1,13,11,2,0,0,0,0,0
3638,136240,3013,Block 3013,156,33.7984598,-84.4133478,156,143,13,143,67,58,1,12,0,0,5
3639,136241,3014,Block 3014,25,33.7991224,-84.4146779,25,25,0,25,23,2,0,0,0,0,0
3640,136244,3017,Block 3017,38,33.7933861,-84.404612,38,38,0,38,23,13,0,0,0,0,2
3641,136245,3018,Block 3018,24,33.7974544,-84.4136415,24,21,3,21,16,3,0,0,0,1,1
3642,136246,3019,Block 3019,10,33.7974789,-84.4153634,10,8,2,8,6,0,0,1,0,0,1
3643,136247,3020,Block 3020,29,33.7966496,-84.414635,29,28,1,28,20,6,1,0,0,0,1
3644,136252,3025,Block 3025,4,33.7862355,-84.4164431,4,2,2,2,1,1,0,0,0,0,0
3645,136257,4001,Block 4001,2,33.8093127,-84.4187105,2,2,0,2,2,0,0,0,0,0,0
3646,136258,4002,Block 4002,97,33.8094284,-84.4204114,97,89,8,89,49,26,0,1,0,10,3
3647,136259,4003,Block 4003,308,33.8099454,-84.4245484,308,250,58,250,178,53,0,10,0,1,8
3648,136260,4004,Block 4004,12,33.8083598,-84.4239973,12,10,2,10,8,0,0,1,0,1,0
3649,136261,4005,Block 4005,28,33.8078957,-84.4222544,28,23,5,23,22,0,0,1,0,0,0
3650,136262,4006,Block 4006,15,33.8080628,-84.4202751,15,14,1,14,14,0,0,0,0,0,0
3651,136263,4007,Block 4007,62,33.8051476,-84.4163758,62,57,5,57,53,2,0,1,0,0,1
3652,136268,4012,Block 4012,492,33.8019771,-84.4120437,492,431,61,431,180,179,2,39,1,8,22
3653,136269,4013,Block 4013,37,33.8027686,-84.4166721,37,30,7,30,29,0,0,0,0,1,0
3654,136270,4014,Block 4014,43,33.8026989,-84.418118,43,40,3,40,36,0,1,1,0,2,0
3655,136271,4015,Block 4015,51,33.8040206,-84.4203372,51,51,0,51,49,2,0,0,0,0,0
3656,136272,4016,Block 4016,21,33.8057003,-84.4221236,21,19,2,19,18,0,0,1,0,0,0
3657,136273,4017,Block 4017,35,33.8059825,-84.4204922,35,33,2,33,33,0,0,0,0,0,0
3658,136274,4018,Block 4018,19,33.8070426,-84.418937,19,19,0,19,17,1,0,1,0,0,0
3659,136275,4019,Block 4019,42,33.8026562,-84.4197439,42,40,2,40,31,4,0,3,0,0,2
3660,136276,4020,Block 4020,5,33.7997769,-84.4086833,5,2,3,2,2,0,0,0,0,0,0
3661,136277,4021,Block 4021,33,33.7998042,-84.4104174,33,26,7,26,13,6,0,2,0,0,5
3662,136278,4022,Block 4022,42,33.7998658,-84.4122603,42,35,7,35,24,6,0,2,0,2,1
3663,136279,4023,Block 4023,26,33.7999948,-84.4146232,26,22,4,22,18,0,0,1,0,1,2
3664,136283,4027,Block 4027,17,33.8070698,-84.4239931,17,15,2,15,13,1,0,0,0,0,1
3665,136284,4028,Block 4028,17,33.8080945,-84.4247241,17,16,1,16,14,2,0,0,0,0,0
3666,136285,4029,Block 4029,4,33.8009478,-84.4165158,4,4,0,4,4,0,0,0,0,0,0
3667,136286,4030,Block 4030,21,33.8056804,-84.4235756,21,19,2,19,15,2,0,2,0,0,0
3668,136293,1004,Block 1004,171,33.8212683,-84.4487817,171,138,33,138,11,76,0,2,0,48,1
3669,136294,1005,Block 1005,69,33.8191361,-84.4470039,69,57,12,57,13,35,0,0,0,8,1
3670,136296,1007,Block 1007,546,33.8172344,-84.4416949,546,448,98,448,229,137,0,25,1,42,14
3671,136297,1008,Block 1008,112,33.8157259,-84.4427068,112,60,52,60,11,27,0,0,0,21,1
3672,136301,1012,Block 1012,187,33.8115635,-84.4375417,187,157,30,157,50,17,0,1,0,75,14
3673,136306,1000,Block 1000,80,33.8209266,-84.4317474,80,76,4,76,74,0,0,1,0,0,1
3674,136307,1001,Block 1001,23,33.8192698,-84.4330313,23,22,1,22,22,0,0,0,0,0,0
3675,136309,1003,Block 1003,1,33.8205064,-84.4340012,1,1,0,1,1,0,0,0,0,0,0
3676,136310,1004,Block 1004,207,33.816506,-84.4281749,207,185,22,185,126,38,0,14,0,0,7
3677,136311,1005,Block 1005,65,33.8191467,-84.4285047,65,61,4,61,59,0,0,0,0,1,1
3678,136312,1006,Block 1006,1,33.8187917,-84.4283193,1,1,0,1,1,0,0,0,0,0,0
3679,136313,1007,Block 1007,24,33.8200969,-84.4276318,24,21,3,21,18,2,0,1,0,0,0
3680,136314,1008,Block 1008,28,33.8195687,-84.4277038,28,27,1,27,27,0,0,0,0,0,0
3681,136315,1009,Block 1009,4,33.819689,-84.4263578,4,4,0,4,4,0,0,0,0,0,0
3682,136319,1013,Block 1013,305,33.8176141,-84.4252207,305,272,33,272,228,34,1,7,0,1,1
3683,136320,1014,Block 1014,2,33.8181257,-84.4256537,2,1,1,1,0,1,0,0,0,0,0
3684,136321,1015,Block 1015,1,33.817876,-84.4242528,1,1,0,1,1,0,0,0,0,0,0
3685,136322,1016,Block 1016,1,33.8188124,-84.4250311,1,1,0,1,1,0,0,0,0,0,0
3686,136323,1017,Block 1017,14,33.8163604,-84.4247096,14,13,1,13,9,1,0,2,0,1,0
3687,136324,1018,Block 1018,6,33.8196781,-84.4259104,6,6,0,6,6,0,0,0,0,0,0
3688,136325,1019,Block 1019,28,33.8182539,-84.4269013,28,25,3,25,24,1,0,0,0,0,0
3689,136326,1020,Block 1020,14,33.8188436,-84.4269983,14,13,1,13,12,0,0,0,0,1,0
3690,136327,1021,Block 1021,28,33.8153498,-84.4296898,28,24,4,24,24,0,0,0,0,0,0
3691,136332,2002,Block 2002,565,33.8202093,-84.4246597,565,504,61,504,368,77,2,41,1,4,11
3692,136337,2007,Block 2007,8,33.8204333,-84.4246317,8,7,1,7,7,0,0,0,0,0,0
3693,136338,2008,Block 2008,4,33.816277,-84.4240225,4,3,1,3,3,0,0,0,0,0,0
3694,136339,2009,Block 2009,42,33.8153114,-84.4236067,42,37,5,37,32,3,0,2,0,0,0
3695,136341,2011,Block 2011,155,33.8119032,-84.421799,155,138,17,138,104,22,0,5,0,5,2
3696,136342,2012,Block 2012,268,33.8125105,-84.424583,268,237,31,237,63,97,0,14,0,43,20
3697,136347,3001,Block 3001,76,33.8299295,-84.4445403,76,74,2,74,74,0,0,0,0,0,0
3698,136348,3002,Block 3002,17,33.8287871,-84.4452485,17,17,0,17,17,0,0,0,0,0,0
3699,136349,3003,Block 3003,22,33.8271534,-84.4462777,22,21,1,21,21,0,0,0,0,0,0
3700,136355,3009,Block 3009,39,33.8247568,-84.4431222,39,38,1,38,33,2,0,1,0,0,2
3701,136356,3010,Block 3010,39,33.8237277,-84.4447061,39,34,5,34,31,2,0,1,0,0,0
3702,136357,3011,Block 3011,10,33.8234802,-84.4471842,10,10,0,10,6,2,0,1,0,1,0
3703,136358,3012,Block 3012,23,33.8247051,-84.4489353,23,22,1,22,22,0,0,0,0,0,0
3704,136359,3013,Block 3013,13,33.8243248,-84.4512721,13,12,1,12,11,1,0,0,0,0,0
3705,136360,3014,Block 3014,19,33.8224852,-84.4475907,19,17,2,17,16,0,0,1,0,0,0
3706,136361,3015,Block 3015,15,33.8223435,-84.4437247,15,15,0,15,13,0,0,1,0,1,0
3707,136362,3016,Block 3016,10,33.8239943,-84.4417035,10,10,0,10,10,0,0,0,0,0,0
3708,136363,3017,Block 3017,21,33.8238894,-84.4410519,21,21,0,21,21,0,0,0,0,0,0
3709,136364,3018,Block 3018,26,33.8238699,-84.4403911,26,25,1,25,24,1,0,0,0,0,0
3710,136365,3019,Block 3019,37,33.823238,-84.4393109,37,32,5,32,29,1,0,1,0,0,1
3711,136366,3020,Block 3020,90,33.8229121,-84.4377136,90,84,6,84,83,1,0,0,0,0,0
3712,136368,3022,Block 3022,52,33.8233012,-84.4349115,52,49,3,49,49,0,0,0,0,0,0
3713,136369,3023,Block 3023,10,33.8245703,-84.4352099,10,10,0,10,9,0,0,1,0,0,0
3714,136370,3024,Block 3024,16,33.8168222,-84.4344583,16,16,0,16,13,3,0,0,0,0,0
3715,136372,3026,Block 3026,19,33.8182195,-84.4327339,19,17,2,17,14,2,0,1,0,0,0
3716,136374,3028,Block 3028,96,33.8199847,-84.4408177,96,90,6,90,85,2,0,2,0,0,1
3717,136375,3029,Block 3029,14,33.8206809,-84.4416029,14,12,2,12,12,0,0,0,0,0,0
3718,136376,3030,Block 3030,1,33.8217209,-84.4457938,1,1,0,1,0,1,0,0,0,0,0
3719,136377,3031,Block 3031,1,33.819354,-84.4393815,1,1,0,1,1,0,0,0,0,0,0
3720,136378,3032,Block 3032,32,33.8225848,-84.4407832,32,31,1,31,28,2,0,0,0,1,0
3721,136379,3033,Block 3033,19,33.8157029,-84.4312799,19,19,0,19,16,1,0,0,0,0,2
3722,136380,3034,Block 3034,134,33.813048,-84.4283808,134,131,3,131,93,23,0,12,0,0,3
3723,136381,3035,Block 3035,1,33.8135076,-84.4275329,1,1,0,1,1,0,0,0,0,0,0
3724,136386,1002,Block 1002,231,33.8209503,-84.4209945,231,222,9,222,217,3,0,2,0,0,0
3725,136388,1004,Block 1004,13,33.820543,-84.4188653,13,13,0,13,13,0,0,0,0,0,0
3726,136389,1005,Block 1005,15,33.8119374,-84.4171465,15,14,1,14,14,0,0,0,0,0,0
3727,136390,1006,Block 1006,10,33.8107183,-84.4134672,10,10,0,10,9,1,0,0,0,0,0
3728,136391,1007,Block 1007,26,33.8211268,-84.4153277,26,25,1,25,21,3,0,0,0,1,0
3729,136393,1009,Block 1009,10,33.8196785,-84.409796,10,10,0,10,9,0,0,0,0,1,0
3730,136394,1010,Block 1010,24,33.8212699,-84.4137165,24,24,0,24,23,0,0,1,0,0,0
3731,136396,1012,Block 1012,21,33.8158071,-84.4053865,21,17,4,17,16,0,0,0,0,0,1
3732,136397,1013,Block 1013,21,33.8115838,-84.4058156,21,21,0,21,21,0,0,0,0,0,0
3733,136398,1014,Block 1014,25,33.8116889,-84.4041143,25,23,2,23,22,0,0,1,0,0,0
3734,136399,1015,Block 1015,15,33.8116664,-84.4074128,15,11,4,11,8,1,0,1,0,0,1
3735,136400,1016,Block 1016,13,33.8112342,-84.4069047,13,12,1,12,11,1,0,0,0,0,0
3736,136401,1017,Block 1017,20,33.8188124,-84.4148741,20,19,1,19,19,0,0,0,0,0,0
3737,136402,1018,Block 1018,22,33.8193059,-84.4135925,22,22,0,22,22,0,0,0,0,0,0
3738,136404,2000,Block 2000,51,33.8178104,-84.410509,51,50,1,50,49,1,0,0,0,0,0
3739,136405,2001,Block 2001,16,33.8181595,-84.4142911,16,16,0,16,16,0,0,0,0,0,0
3740,136406,2002,Block 2002,31,33.8173569,-84.4176163,31,31,0,31,31,0,0,0,0,0,0
3741,136408,2004,Block 2004,39,33.8159234,-84.4118882,39,37,2,37,35,0,0,1,0,0,1
3742,136409,2005,Block 2005,42,33.8166411,-84.4112024,42,40,2,40,39,0,0,1,0,0,0
3743,136411,2007,Block 2007,41,33.815773,-84.4177312,41,40,1,40,40,0,0,0,0,0,0
3744,136412,2008,Block 2008,23,33.8143449,-84.4181526,23,22,1,22,22,0,0,0,0,0,0
3745,136413,2009,Block 2009,18,33.8142226,-84.4157781,18,18,0,18,18,0,0,0,0,0,0
3746,136414,2010,Block 2010,56,33.813635,-84.4137823,56,53,3,53,51,0,0,1,0,1,0
3747,136415,2011,Block 2011,9,33.8150665,-84.4131998,9,9,0,9,9,0,0,0,0,0,0
3748,136416,2012,Block 2012,21,33.8149426,-84.4115028,21,21,0,21,21,0,0,0,0,0,0
3749,136417,2013,Block 2013,46,33.814129,-84.4108285,46,44,2,44,43,0,0,1,0,0,0
3750,136418,2014,Block 2014,37,33.8132391,-84.4103295,37,36,1,36,36,0,0,0,0,0,0
3751,136419,2015,Block 2015,30,33.8127732,-84.4096169,30,28,2,28,25,0,0,2,0,0,1
3752,136421,2017,Block 2017,9,33.8113139,-84.410407,9,9,0,9,7,0,0,0,0,0,2
3753,136422,2018,Block 2018,10,33.8112246,-84.4080609,10,10,0,10,10,0,0,0,0,0,0
3754,136423,2019,Block 2019,12,33.8110591,-84.4096576,12,12,0,12,12,0,0,0,0,0,0
3755,136424,2020,Block 2020,10,33.8101196,-84.4095831,10,10,0,10,9,1,0,0,0,0,0
3756,136426,2022,Block 2022,22,33.8132192,-84.4176226,22,22,0,22,22,0,0,0,0,0,0
3757,136429,3001,Block 3001,19,33.8102243,-84.4051692,19,17,2,17,17,0,0,0,0,0,0
3758,136430,3002,Block 3002,20,33.8093739,-84.4071289,20,19,1,19,17,0,0,1,0,0,1
3759,136431,3003,Block 3003,66,33.8081005,-84.4096937,66,60,6,60,56,2,1,1,0,0,0
3760,136433,3005,Block 3005,536,33.8088684,-84.4162005,536,503,33,503,359,70,1,56,0,11,6
3761,136434,3006,Block 3006,1,33.8067993,-84.4143371,1,1,0,1,1,0,0,0,0,0,0
3762,136435,3007,Block 3007,179,33.8056301,-84.4104871,179,157,22,157,101,43,1,7,0,0,5
3763,136436,3008,Block 3008,21,33.806588,-84.4071115,21,21,0,21,21,0,0,0,0,0,0
3764,136437,3009,Block 3009,40,33.8038685,-84.4060273,40,38,2,38,37,1,0,0,0,0,0
3765,136438,3010,Block 3010,48,33.8064208,-84.4053649,48,47,1,47,46,0,0,0,1,0,0
3766,136439,3011,Block 3011,18,33.8051663,-84.4048386,18,17,1,17,17,0,0,0,0,0,0
3767,136440,3012,Block 3012,26,33.8058149,-84.4034983,26,25,1,25,25,0,0,0,0,0,0
3768,136441,3013,Block 3013,24,33.8087954,-84.4046476,24,24,0,24,23,0,0,1,0,0,0
3769,136450,1001,Block 1001,695,33.816884,-84.3927189,695,588,107,588,402,150,2,10,0,10,14
3770,136451,1002,Block 1002,305,33.8142309,-84.3997224,305,267,38,267,219,30,0,9,0,4,5
3771,136452,1003,Block 1003,7,33.8139659,-84.3958598,7,5,2,5,1,2,0,1,0,1,0
3772,136454,1005,Block 1005,60,33.8145582,-84.396682,60,49,11,49,36,10,0,2,0,1,0
3773,136457,1008,Block 1008,23,33.8097876,-84.4003806,23,22,1,22,22,0,0,0,0,0,0
3774,136458,1009,Block 1009,32,33.8112358,-84.3983655,32,31,1,31,31,0,0,0,0,0,0
3775,136460,2000,Block 2000,99,33.8066454,-84.3979513,99,84,15,84,72,8,0,3,0,0,1
3776,136461,2001,Block 2001,26,33.8055798,-84.399852,26,24,2,24,22,0,0,0,0,0,2
3777,136462,2002,Block 2002,19,33.8079987,-84.4010093,19,13,6,13,13,0,0,0,0,0,0
3778,136464,2004,Block 2004,30,33.8088579,-84.4006594,30,27,3,27,26,0,0,1,0,0,0
3779,136465,2005,Block 2005,90,33.8064596,-84.396497,90,85,5,85,83,0,0,2,0,0,0
3780,136466,2006,Block 2006,52,33.8062193,-84.3950019,52,50,2,50,48,0,0,0,0,1,1
3781,136468,2008,Block 2008,731,33.8011639,-84.3980851,731,663,68,663,490,112,0,32,0,8,21
3782,136470,2010,Block 2010,19,33.8027731,-84.4004757,19,16,3,16,11,4,0,1,0,0,0
3783,136471,2011,Block 2011,2,33.7985156,-84.3937632,2,2,0,2,2,0,0,0,0,0,0
3784,136472,2012,Block 2012,6,33.8042359,-84.398464,6,6,0,6,6,0,0,0,0,0,0
3785,136475,3001,Block 3001,201,33.8127675,-84.3947017,201,158,43,158,104,40,0,11,0,1,2
3786,136477,3003,Block 3003,71,33.813408,-84.3963288,71,60,11,60,41,15,0,3,0,0,1
3787,136478,3004,Block 3004,20,33.8108291,-84.3961331,20,20,0,20,20,0,0,0,0,0,0
3788,136483,4001,Block 4001,309,33.8037167,-84.3954357,309,273,36,273,176,65,0,19,1,8,4
3789,136484,4002,Block 4002,134,33.8016306,-84.3949801,134,102,32,102,84,13,1,1,0,2,1
3790,136486,4004,Block 4004,24,33.800186,-84.3936331,24,22,2,22,15,2,1,2,0,0,2
3791,136487,4005,Block 4005,68,33.7994166,-84.3949696,68,37,31,37,30,5,0,0,0,2,0
3792,136488,4006,Block 4006,218,33.8030789,-84.3985399,218,187,31,187,112,57,0,13,0,1,4
3793,136491,1000,Block 1000,31,33.8098683,-84.386736,31,30,1,30,30,0,0,0,0,0,0
3794,136492,1001,Block 1001,32,33.8083783,-84.3902471,32,30,2,30,29,0,0,0,0,0,1
3795,136493,1002,Block 1002,18,33.8065651,-84.3928628,18,14,4,14,14,0,0,0,0,0,0
3796,136494,1003,Block 1003,26,33.8074847,-84.3900434,26,26,0,26,26,0,0,0,0,0,0
3797,136495,1004,Block 1004,11,33.8065389,-84.3887486,11,11,0,11,11,0,0,0,0,0,0
3798,136496,1005,Block 1005,36,33.8042832,-84.3884204,36,32,4,32,32,0,0,0,0,0,0
3799,136497,1006,Block 1006,35,33.804141,-84.3899624,35,35,0,35,35,0,0,0,0,0,0
3800,136498,1007,Block 1007,18,33.8058849,-84.3910433,18,18,0,18,18,0,0,0,0,0,0
3801,136499,1008,Block 1008,55,33.8037344,-84.3919619,55,47,8,47,46,1,0,0,0,0,0
3802,136500,1009,Block 1009,1,33.8048839,-84.3930167,1,1,0,1,1,0,0,0,0,0,0
3803,136511,2009,Block 2009,763,33.8133438,-84.3889483,763,535,228,535,341,130,2,28,0,18,16
3804,136512,2010,Block 2010,20,33.8135259,-84.3899989,20,9,11,9,6,2,0,1,0,0,0
3805,136515,3000,Block 3000,1465,33.8078688,-84.3882565,1465,1358,107,1358,632,585,4,71,2,11,53
3806,136523,1005,Block 1005,150,33.8167646,-84.3652881,150,141,9,141,68,50,0,15,0,6,2
3807,136526,1008,Block 1008,1,33.8154311,-84.364845,1,1,0,1,1,0,0,0,0,0,0
3808,136538,1020,Block 1020,369,33.8118038,-84.3746028,369,334,35,334,169,135,1,12,0,5,12
3809,136547,1029,Block 1029,1,33.811657,-84.3676901,1,1,0,1,0,1,0,0,0,0,0
3810,136549,1031,Block 1031,848,33.8084783,-84.3707161,848,712,136,712,467,168,1,43,1,10,22
3811,136551,1033,Block 1033,41,33.8074594,-84.3757547,41,38,3,38,36,1,0,0,0,0,1
3812,136553,1035,Block 1035,27,33.8032694,-84.3749209,27,24,3,24,24,0,0,0,0,0,0
3813,136554,1036,Block 1036,33,33.8032324,-84.3740616,33,29,4,29,27,0,0,0,1,0,1
3814,136555,1037,Block 1037,30,33.8038251,-84.3739445,30,29,1,29,25,3,0,0,0,0,1
3815,136556,1038,Block 1038,22,33.8025409,-84.3713746,22,22,0,22,21,1,0,0,0,0,0
3816,136557,1039,Block 1039,33,33.8033523,-84.3721012,33,32,1,32,28,2,0,0,0,1,1
3817,136558,1040,Block 1040,102,33.8045692,-84.370683,102,94,8,94,86,4,0,4,0,0,0
3818,136559,1041,Block 1041,66,33.8061203,-84.3711232,66,61,5,61,57,1,0,1,0,0,2
3819,136560,1042,Block 1042,21,33.8032298,-84.3700046,21,19,2,19,17,1,0,1,0,0,0
3820,136563,2001,Block 2001,21,33.8222579,-84.3498431,21,20,1,20,17,1,0,1,0,0,1
3821,136564,2002,Block 2002,11,33.8190908,-84.3497916,11,9,2,9,9,0,0,0,0,0,0
3822,136565,2003,Block 2003,568,33.8163392,-84.3502875,568,508,60,508,201,159,1,38,0,92,17
3823,136566,2004,Block 2004,6,33.8154954,-84.3522615,6,6,0,6,2,2,1,1,0,0,0
3824,136567,2005,Block 2005,48,33.8139274,-84.3528251,48,44,4,44,10,5,1,0,0,28,0
3825,136568,2006,Block 2006,236,33.8135474,-84.3498554,236,192,44,192,101,43,1,2,0,43,2
3826,136569,2007,Block 2007,14,33.8119219,-84.3526074,14,14,0,14,13,0,0,0,0,1,0
3827,136572,2010,Block 2010,27,33.8103143,-84.350104,27,26,1,26,20,0,0,2,0,2,2
3828,136573,2011,Block 2011,12,33.8105161,-84.348973,12,11,1,11,10,0,0,0,1,0,0
3829,136574,2012,Block 2012,13,33.8116595,-84.3504063,13,11,2,11,11,0,0,0,0,0,0
3830,136575,2013,Block 2013,37,33.8116959,-84.3488312,37,35,2,35,32,3,0,0,0,0,0
3831,136577,3000,Block 3000,191,33.8212569,-84.3535051,191,171,20,171,82,66,0,12,0,2,9
3832,136578,3001,Block 3001,14,33.8211827,-84.3546577,14,14,0,14,14,0,0,0,0,0,0
3833,136579,3002,Block 3002,31,33.8202705,-84.355193,31,27,4,27,25,0,0,1,0,0,1
3834,136581,3004,Block 3004,681,33.815934,-84.3576828,681,650,31,650,410,169,1,53,0,7,10
3835,136582,3005,Block 3005,21,33.8176349,-84.3573937,21,20,1,20,20,0,0,0,0,0,0
3836,136583,3006,Block 3006,11,33.8152122,-84.3602482,11,10,1,10,10,0,0,0,0,0,0
3837,136584,3007,Block 3007,12,33.8152046,-84.360684,12,12,0,12,11,0,0,1,0,0,0
3838,136585,3008,Block 3008,41,33.8184052,-84.3581748,41,35,6,35,31,3,0,0,0,1,0
3839,136586,3009,Block 3009,30,33.8174105,-84.3555058,30,26,4,26,26,0,0,0,0,0,0
3840,136605,3028,Block 3028,213,33.8125042,-84.3657427,213,186,27,186,55,109,2,2,0,8,10
3841,136606,3029,Block 3029,7,33.8179965,-84.3528373,7,6,1,6,5,0,0,1,0,0,0
3842,136607,3030,Block 3030,30,33.818932,-84.3552989,30,30,0,30,25,2,0,2,0,0,1
3843,136608,3031,Block 3031,3,33.810374,-84.3621695,3,2,1,2,1,1,0,0,0,0,0
3844,136609,3032,Block 3032,10,33.8110923,-84.3648392,10,6,4,6,3,3,0,0,0,0,0
3845,136610,3033,Block 3033,1,33.8091643,-84.3645298,1,1,0,1,0,1,0,0,0,0,0
3846,136613,1000,Block 1000,159,33.8253401,-84.371463,159,144,15,144,135,4,0,1,0,1,3
3847,136614,1001,Block 1001,48,33.8274671,-84.3720499,48,47,1,47,43,0,0,4,0,0,0
3848,136615,1002,Block 1002,40,33.8250432,-84.3740596,40,38,2,38,35,2,0,1,0,0,0
3849,136616,1003,Block 1003,30,33.8272905,-84.3748645,30,29,1,29,29,0,0,0,0,0,0
3850,136617,1004,Block 1004,98,33.8254981,-84.3768669,98,90,8,90,83,2,0,5,0,0,0
3851,136618,1005,Block 1005,13,33.8230104,-84.376823,13,12,1,12,12,0,0,0,0,0,0
3852,136619,1006,Block 1006,13,33.8274797,-84.3790103,13,13,0,13,13,0,0,0,0,0,0
3853,136620,1007,Block 1007,28,33.8256826,-84.379005,28,27,1,27,27,0,0,0,0,0,0
3854,136621,1008,Block 1008,24,33.8236191,-84.3790119,24,20,4,20,19,0,0,1,0,0,0
3855,136623,2000,Block 2000,58,33.8170344,-84.376784,58,51,7,51,50,0,0,0,0,1,0
3856,136624,2001,Block 2001,548,33.8195345,-84.3771455,548,516,32,516,435,51,2,11,0,5,12
3857,136625,2002,Block 2002,40,33.8212824,-84.3779947,40,37,3,37,35,1,0,1,0,0,0
3858,136626,2003,Block 2003,31,33.8222466,-84.3785224,31,28,3,28,27,1,0,0,0,0,0
3859,136627,2004,Block 2004,15,33.8223095,-84.3808964,15,13,2,13,12,0,0,1,0,0,0
3860,136628,2005,Block 2005,21,33.8212723,-84.3808773,21,21,0,21,20,1,0,0,0,0,0
3861,136631,2008,Block 2008,70,33.8138443,-84.3873528,70,66,4,66,60,3,0,1,0,0,2
3862,136633,3000,Block 3000,19,33.8222957,-84.3825249,19,16,3,16,16,0,0,0,0,0,0
3863,136634,3001,Block 3001,18,33.8221491,-84.3836991,18,15,3,15,15,0,0,0,0,0,0
3864,136635,3002,Block 3002,337,33.8221451,-84.3860526,337,281,56,281,186,73,0,14,0,2,6
3865,136636,3003,Block 3003,44,33.8197276,-84.3817041,44,41,3,41,41,0,0,0,0,0,0
3866,136637,3004,Block 3004,6,33.8214868,-84.3828306,6,5,1,5,5,0,0,0,0,0,0
3867,136638,3005,Block 3005,8,33.8206922,-84.3828728,8,8,0,8,7,0,0,0,0,1,0
3868,136639,3006,Block 3006,35,33.8211049,-84.3844317,35,34,1,34,32,2,0,0,0,0,0
3869,136640,3007,Block 3007,95,33.8191896,-84.3858429,95,85,10,85,82,2,1,0,0,0,0
3870,136641,3008,Block 3008,10,33.8196724,-84.3828709,10,10,0,10,9,0,1,0,0,0,0
3871,136642,3009,Block 3009,30,33.8198317,-84.3844508,30,27,3,27,26,1,0,0,0,0,0
3872,136643,3010,Block 3010,57,33.8162945,-84.3832305,57,54,3,54,51,1,0,1,0,1,0
3873,136644,3011,Block 3011,92,33.8172236,-84.3861212,92,83,9,83,77,3,0,1,0,0,2
3874,136645,3012,Block 3012,34,33.8150762,-84.3851315,34,33,1,33,31,0,0,0,0,0,2
3875,136646,3013,Block 3013,44,33.8152915,-84.386578,44,44,0,44,43,0,1,0,0,0,0
3876,136647,3014,Block 3014,29,33.8157848,-84.3877809,29,29,0,29,26,2,0,0,0,0,1
3877,136648,3015,Block 3015,37,33.8162164,-84.3817085,37,37,0,37,35,0,0,0,0,1,1
3878,136650,4000,Block 4000,15,33.8283677,-84.37952,15,13,2,13,13,0,0,0,0,0,0
3879,136651,4001,Block 4001,53,33.8280136,-84.3837038,53,52,1,52,51,1,0,0,0,0,0
3880,136652,4002,Block 4002,28,33.8258575,-84.3831801,28,28,0,28,27,1,0,0,0,0,0
3881,136653,4003,Block 4003,9,33.8265414,-84.3843461,9,9,0,9,8,1,0,0,0,0,0
3882,136654,4004,Block 4004,226,33.8263813,-84.3862306,226,198,28,198,189,6,0,0,0,2,1
3883,136655,4005,Block 4005,99,33.8240456,-84.3864853,99,95,4,95,90,5,0,0,0,0,0
3884,136657,4007,Block 4007,51,33.8236448,-84.3831317,51,44,7,44,42,1,0,0,0,0,1
3885,136658,4008,Block 4008,25,33.8257274,-84.3816376,25,24,1,24,23,0,0,0,0,1,0
3886,136659,4009,Block 4009,29,33.8257598,-84.3801381,29,28,1,28,27,0,0,0,0,1,0
3887,136660,4010,Block 4010,15,33.8275392,-84.3801463,15,15,0,15,14,1,0,0,0,0,0
3888,136661,4011,Block 4011,23,33.8236948,-84.3801303,23,19,4,19,19,0,0,0,0,0,0
3889,136664,1000,Block 1000,774,33.8237947,-84.3704757,774,355,419,355,131,163,0,35,0,8,18
3890,136670,1006,Block 1006,10,33.8181532,-84.3697159,10,9,1,9,7,1,0,1,0,0,0
3891,136673,1009,Block 1009,297,33.8191886,-84.3658481,297,103,194,103,40,50,0,9,0,1,3
3892,136674,1010,Block 1010,398,33.8198632,-84.3641636,398,192,206,192,60,115,0,3,2,7,5
3893,136675,1011,Block 1011,204,33.819595,-84.3625043,204,190,14,190,82,79,0,15,1,5,8
3894,136682,1018,Block 1018,335,33.8190465,-84.3719506,335,329,6,329,224,49,0,48,0,4,4
3895,136687,2003,Block 2003,112,33.8242619,-84.3544644,112,100,12,100,25,12,1,3,0,50,9
3896,136691,2007,Block 2007,319,33.8243786,-84.363318,319,252,67,252,152,75,0,9,0,8,8
3897,136692,2008,Block 2008,36,33.8229911,-84.3659971,36,34,2,34,11,1,1,0,0,18,3
3898,136696,2012,Block 2012,1,33.8238874,-84.3527964,1,1,0,1,0,0,0,0,0,0,1
3899,136701,2017,Block 2017,99,33.8220126,-84.3642372,99,91,8,91,24,9,3,1,0,47,7
3900,136702,2018,Block 2018,82,33.8219745,-84.3662939,82,62,20,62,25,0,1,0,0,34,2
3901,136703,2019,Block 2019,260,33.8216637,-84.3620252,260,235,25,235,129,65,0,35,0,1,5
3902,136709,1000,Block 1000,164,33.8392878,-84.3589709,164,163,1,163,128,25,0,7,0,2,1
3903,136710,1001,Block 1001,425,33.8429243,-84.3591075,425,379,46,379,106,160,2,59,0,25,27
3904,136711,1002,Block 1002,70,33.8342331,-84.3584409,70,60,10,60,39,12,1,8,0,0,0
3905,136712,1003,Block 1003,8,33.8330628,-84.3585651,8,8,0,8,4,1,0,3,0,0,0
3906,136713,1004,Block 1004,376,33.8303627,-84.3576374,376,342,34,342,257,62,1,18,0,2,2
3907,136715,1006,Block 1006,351,33.8271719,-84.359014,351,331,20,331,204,91,3,25,0,2,6
3908,136717,2000,Block 2000,791,33.8263039,-84.3564585,791,721,70,721,444,183,2,70,1,11,10
3909,136718,2001,Block 2001,259,33.8268747,-84.3582661,259,250,9,250,149,83,1,13,0,2,2
3910,136720,2003,Block 2003,1,33.8258179,-84.354016,1,1,0,1,1,0,0,0,0,0,0
3911,136728,3006,Block 3006,1,33.8358712,-84.3600397,1,1,0,1,0,1,0,0,0,0,0
3912,136738,3016,Block 3016,787,33.8280051,-84.3633593,787,753,34,753,399,236,1,90,0,18,9
3913,136743,1000,Block 1000,27,33.8403591,-84.3514534,27,26,1,26,24,0,0,1,0,0,1
3914,136744,1001,Block 1001,355,33.8390225,-84.3554536,355,317,38,317,240,46,0,21,0,2,8
3915,136746,1003,Block 1003,411,33.8369828,-84.3524971,411,362,49,362,290,43,0,23,0,2,4
3916,136747,1004,Block 1004,8,33.8381071,-84.351653,8,8,0,8,8,0,0,0,0,0,0
3917,136748,1005,Block 1005,46,33.8316097,-84.3555989,46,41,5,41,38,3,0,0,0,0,0
3918,136749,1006,Block 1006,349,33.8281907,-84.3530739,349,315,34,315,176,91,0,38,0,5,5
3919,136750,1007,Block 1007,54,33.8305944,-84.3541244,54,48,6,48,36,5,0,4,0,2,1
3920,136754,2002,Block 2002,469,33.8509025,-84.350136,469,420,49,420,335,41,0,32,0,4,8
3921,136755,2003,Block 2003,373,33.8499844,-84.3494472,373,355,18,355,286,24,0,30,0,0,15
3922,136756,2004,Block 2004,23,33.8475791,-84.3486604,23,22,1,22,22,0,0,0,0,0,0
3923,136758,2006,Block 2006,113,33.8455567,-84.3532566,113,91,22,91,69,14,0,7,0,0,1
3924,136759,2007,Block 2007,6,33.8446176,-84.3488758,6,6,0,6,6,0,0,0,0,0,0
3925,136760,2008,Block 2008,20,33.846452,-84.3516958,20,19,1,19,17,2,0,0,0,0,0
3926,136761,2009,Block 2009,17,33.8445062,-84.3551339,17,15,2,15,12,1,0,2,0,0,0
3927,136764,2012,Block 2012,151,33.842746,-84.3539556,151,128,23,128,96,24,0,5,0,0,3
3928,136765,2013,Block 2013,14,33.8435707,-84.3493898,14,14,0,14,13,0,0,0,0,0,1
3929,136766,2014,Block 2014,28,33.841271,-84.3494208,28,26,2,26,24,2,0,0,0,0,0
3930,136767,2015,Block 2015,7,33.838452,-84.3486879,7,7,0,7,7,0,0,0,0,0,0
3931,136768,2016,Block 2016,25,33.8332728,-84.3492234,25,22,3,22,19,1,0,1,0,0,1
3932,136769,2017,Block 2017,23,33.8473464,-84.3500263,23,22,1,22,21,0,0,1,0,0,0
3933,136771,3000,Block 3000,18,33.8359853,-84.3510805,18,17,1,17,15,1,0,1,0,0,0
3934,136772,3001,Block 3001,79,33.8327465,-84.3522099,79,72,7,72,64,5,0,0,0,1,2
3935,136773,3002,Block 3002,20,33.8277396,-84.3502354,20,17,3,17,15,2,0,0,0,0,0
3936,136775,3004,Block 3004,10,33.8299201,-84.349111,10,9,1,9,7,0,0,1,0,0,1
3937,136776,3005,Block 3005,1,33.8311584,-84.3485315,1,0,1,0,0,0,0,0,0,0,0
3938,136777,3006,Block 3006,24,33.8277825,-84.3489653,24,21,3,21,14,6,0,1,0,0,0
3939,136784,1004,Block 1004,16,33.8194971,-84.3908352,16,16,0,16,16,0,0,0,0,0,0
3940,136786,1006,Block 1006,2,33.8217301,-84.3944945,2,2,0,2,2,0,0,0,0,0,0
3941,136787,1007,Block 1007,11,33.8217899,-84.3969488,11,9,2,9,9,0,0,0,0,0,0
3942,136788,1008,Block 1008,28,33.8197206,-84.3973676,28,26,2,26,26,0,0,0,0,0,0
3943,136789,1009,Block 1009,26,33.8203254,-84.3990355,26,26,0,26,26,0,0,0,0,0,0
3944,136790,1010,Block 1010,20,33.8203494,-84.4005996,20,19,1,19,19,0,0,0,0,0,0
3945,136791,1011,Block 1011,22,33.8203727,-84.4021233,22,20,2,20,20,0,0,0,0,0,0
3946,136792,1012,Block 1012,29,33.8209719,-84.4045952,29,26,3,26,25,0,0,1,0,0,0
3947,136793,1013,Block 1013,9,33.8222631,-84.4069269,9,9,0,9,8,0,0,1,0,0,0
3948,136795,1015,Block 1015,9,33.818353,-84.401894,9,8,1,8,8,0,0,0,0,0,0
3949,136796,1016,Block 1016,10,33.8172542,-84.4009096,10,9,1,9,9,0,0,0,0,0,0
3950,136797,1017,Block 1017,14,33.8181567,-84.4006144,14,14,0,14,14,0,0,0,0,0,0
3951,136799,1019,Block 1019,24,33.8182145,-84.3956137,24,24,0,24,24,0,0,0,0,0,0
3952,136800,1020,Block 1020,18,33.8206577,-84.3946877,18,18,0,18,18,0,0,0,0,0,0
3953,136801,1021,Block 1021,1,33.8206468,-84.3909279,1,1,0,1,0,0,0,1,0,0,0
3954,136802,1022,Block 1022,15,33.818133,-84.3990523,15,14,1,14,14,0,0,0,0,0,0
3955,136806,2001,Block 2001,492,33.8265354,-84.3888103,492,369,123,369,342,18,0,6,0,0,3
3956,136807,2002,Block 2002,23,33.8270046,-84.3909697,23,23,0,23,23,0,0,0,0,0,0
3957,136808,2003,Block 2003,11,33.8275734,-84.393091,11,11,0,11,11,0,0,0,0,0,0
3958,136809,2004,Block 2004,54,33.8262511,-84.3975637,54,50,4,50,49,1,0,0,0,0,0
3959,136810,2005,Block 2005,21,33.8270216,-84.401851,21,20,1,20,19,1,0,0,0,0,0
3960,136811,2006,Block 2006,25,33.8276309,-84.4056881,25,24,1,24,24,0,0,0,0,0,0
3961,136812,2007,Block 2007,32,33.8255752,-84.4052613,32,32,0,32,30,0,0,2,0,0,0
3962,136813,2008,Block 2008,46,33.8246808,-84.4013864,46,44,2,44,43,0,0,0,1,0,0
3963,136814,2009,Block 2009,25,33.8243184,-84.3920908,25,25,0,25,23,1,0,0,0,1,0
3964,136815,2010,Block 2010,38,33.8237981,-84.3944127,38,36,2,36,35,0,0,0,0,1,0
3965,136816,2011,Block 2011,423,33.8224691,-84.3893775,423,371,52,371,310,35,1,15,0,1,9
3966,136818,2013,Block 2013,13,33.8228077,-84.4021086,13,13,0,13,13,0,0,0,0,0,0
3967,136820,2015,Block 2015,29,33.8228758,-84.4047258,29,27,2,27,27,0,0,0,0,0,0
3968,136822,2017,Block 2017,22,33.8227476,-84.3997807,22,17,5,17,15,2,0,0,0,0,0
3969,136825,3000,Block 3000,30,33.8413333,-84.3922044,30,29,1,29,28,1,0,0,0,0,0
3970,136826,3001,Block 3001,32,33.8406371,-84.3949233,32,30,2,30,30,0,0,0,0,0,0
3971,136827,3002,Block 3002,44,33.8406615,-84.3985138,44,41,3,41,41,0,0,0,0,0,0
3972,136828,3003,Block 3003,40,33.8370216,-84.4027983,40,37,3,37,34,0,0,2,0,0,1
3973,136829,3004,Block 3004,1,33.8365482,-84.4035615,1,1,0,1,0,0,0,0,0,0,1
3974,136830,3005,Block 3005,1,33.83783,-84.4026916,1,1,0,1,1,0,0,0,0,0,0
3975,136832,3007,Block 3007,19,33.8372851,-84.3982554,19,18,1,18,18,0,0,0,0,0,0
3976,136833,3008,Block 3008,61,33.8367612,-84.3927862,61,58,3,58,58,0,0,0,0,0,0
3977,136835,3010,Block 3010,26,33.8337112,-84.4049626,26,22,4,22,22,0,0,0,0,0,0
3978,136836,3011,Block 3011,28,33.8340633,-84.3920629,28,27,1,27,27,0,0,0,0,0,0
3979,136838,3013,Block 3013,119,33.830892,-84.3894609,119,97,22,97,97,0,0,0,0,0,0
3980,136841,3016,Block 3016,23,33.8303841,-84.4048826,23,21,2,21,21,0,0,0,0,0,0
3981,136842,3017,Block 3017,104,33.8319301,-84.3985121,104,102,2,102,102,0,0,0,0,0,0
3982,136843,3018,Block 3018,22,33.8302732,-84.3921243,22,20,2,20,20,0,0,0,0,0,0
3983,136846,1000,Block 1000,53,33.8524211,-84.3836027,53,51,2,51,47,3,0,1,0,0,0
3984,136847,1001,Block 1001,11,33.8515235,-84.3843947,11,9,2,9,9,0,0,0,0,0,0
3985,136848,1002,Block 1002,138,33.85084,-84.3847242,138,105,33,105,84,7,0,3,0,9,2
3986,136850,1004,Block 1004,36,33.8493998,-84.3849072,36,33,3,33,32,0,0,1,0,0,0
3987,136851,1005,Block 1005,63,33.8461518,-84.3841042,63,46,17,46,46,0,0,0,0,0,0
3988,136852,1006,Block 1006,15,33.8461017,-84.3854527,15,15,0,15,15,0,0,0,0,0,0
3989,136853,1007,Block 1007,227,33.8442201,-84.3811191,227,102,125,102,98,3,1,0,0,0,0
3990,136855,1009,Block 1009,1,33.8424358,-84.381246,1,1,0,1,0,0,0,1,0,0,0
3991,136856,1010,Block 1010,9,33.8419854,-84.3829468,9,7,2,7,6,1,0,0,0,0,0
3992,136857,1011,Block 1011,3,33.8430032,-84.3837763,3,2,1,2,1,1,0,0,0,0,0
3993,136858,1012,Block 1012,42,33.8459811,-84.3887295,42,39,3,39,36,1,0,2,0,0,0
3994,136860,1014,Block 1014,17,33.8461051,-84.3922062,17,16,1,16,15,0,0,1,0,0,0
3995,136861,1015,Block 1015,24,33.8454756,-84.3941983,24,23,1,23,23,0,0,0,0,0,0
3996,136865,2000,Block 2000,488,33.8356999,-84.383676,488,439,49,439,328,79,2,8,0,10,12
3997,136868,3000,Block 3000,35,33.8427306,-84.3898495,35,31,4,31,29,0,0,2,0,0,0
3998,136869,3001,Block 3001,14,33.8400559,-84.3875547,14,12,2,12,12,0,0,0,0,0,0
3999,136870,3002,Block 3002,751,33.8388189,-84.3836895,751,594,157,594,443,121,0,17,2,2,9
4000,136875,4001,Block 4001,1042,33.833886,-84.3866029,1042,936,106,936,703,165,3,29,0,18,18
4001,136877,4003,Block 4003,1,33.831018,-84.3872199,1,0,1,0,0,0,0,0,0,0,0
4002,136882,1001,Block 1001,202,33.8451839,-84.373992,202,160,42,160,130,16,0,13,0,0,1
4003,136883,1002,Block 1002,7,33.8469387,-84.3747915,7,5,2,5,5,0,0,0,0,0,0
4004,136884,1003,Block 1003,42,33.8442818,-84.3763654,42,38,4,38,35,2,0,1,0,0,0
4005,136885,1004,Block 1004,529,33.8439617,-84.3787173,529,475,54,475,406,36,3,9,0,8,13
4006,136890,2000,Block 2000,1,33.8536247,-84.3822868,1,1,0,1,1,0,0,0,0,0,0
4007,136891,2001,Block 2001,778,33.8490617,-84.3793196,778,648,130,648,508,93,1,22,1,9,14
4008,136892,2002,Block 2002,48,33.8498285,-84.3822884,48,44,4,44,36,7,0,0,0,0,1
4009,136893,2003,Block 2003,33,33.8492874,-84.3815671,33,31,2,31,19,8,1,1,0,2,0
4010,136895,2005,Block 2005,85,33.850903,-84.3825624,85,74,11,74,56,10,1,3,0,2,2
4011,136896,2006,Block 2006,6,33.8503967,-84.3824409,6,6,0,6,6,0,0,0,0,0,0
4012,136899,1000,Block 1000,898,33.8553228,-84.3502265,898,607,291,607,563,23,0,13,0,2,6
4013,136901,1002,Block 1002,3,33.8498152,-84.3535657,3,3,0,3,2,0,0,1,0,0,0
4014,136902,1003,Block 1003,123,33.8538962,-84.3518377,123,110,13,110,74,25,0,3,0,7,1
4015,136905,2000,Block 2000,240,33.8533644,-84.3553268,240,194,46,194,166,15,1,7,0,3,2
4016,136908,2003,Block 2003,33,33.8518359,-84.3543791,33,32,1,32,32,0,0,0,0,0,0
4017,136909,2004,Block 2004,24,33.8517316,-84.3569766,24,23,1,23,18,1,0,1,0,2,1
4018,136910,2005,Block 2005,266,33.8506808,-84.3578888,266,238,28,238,155,42,0,29,0,10,2
4019,136911,2006,Block 2006,224,33.8501427,-84.3592559,224,195,29,195,163,21,0,10,0,0,1
4020,136912,2007,Block 2007,57,33.8484898,-84.3578611,57,50,7,50,44,2,0,3,0,0,1
4021,136913,2008,Block 2008,677,33.8490291,-84.3558572,677,599,78,599,428,87,10,46,0,13,15
4022,136915,2010,Block 2010,1,33.8472788,-84.3565708,1,1,0,1,1,0,0,0,0,0,0
4023,136924,3007,Block 3007,92,33.8393935,-84.3620798,92,88,4,88,81,4,0,1,0,0,2
4024,136925,3008,Block 3008,39,33.836037,-84.3644988,39,37,2,37,37,0,0,0,0,0,0
4025,136926,3009,Block 3009,42,33.8409253,-84.3645213,42,40,2,40,40,0,0,0,0,0,0
4026,136927,3010,Block 3010,46,33.8336678,-84.3661684,46,44,2,44,42,1,0,0,0,1,0
4027,136928,3011,Block 3011,44,33.8387368,-84.3643348,44,43,1,43,40,1,1,1,0,0,0
4028,136929,3012,Block 3012,39,33.8336246,-84.3640658,39,35,4,35,34,0,0,1,0,0,0
4029,136930,3013,Block 3013,74,33.8455633,-84.3672368,74,60,14,60,60,0,0,0,0,0,0
4030,136931,3014,Block 3014,34,33.8438297,-84.3659858,34,31,3,31,31,0,0,0,0,0,0
4031,136932,3015,Block 3015,10,33.8428246,-84.3668919,10,9,1,9,9,0,0,0,0,0,0
4032,136933,3016,Block 3016,63,33.8370395,-84.3650251,63,56,7,56,55,1,0,0,0,0,0
4033,136934,3017,Block 3017,17,33.8389814,-84.3676495,17,17,0,17,14,1,0,2,0,0,0
4034,136935,3018,Block 3018,25,33.841093,-84.3686346,25,25,0,25,21,0,0,0,0,2,2
4035,136936,3019,Block 3019,26,33.8434746,-84.3691493,26,23,3,23,21,0,0,1,0,0,1
4036,136938,3021,Block 3021,27,33.834967,-84.3669235,27,24,3,24,20,3,0,0,0,1,0
4037,136943,1001,Block 1001,2,33.8402411,-84.3730828,2,2,0,2,2,0,0,0,0,0,0
4038,136944,1002,Block 1002,171,33.8400248,-84.3751345,171,137,34,137,97,25,2,5,0,4,4
4039,136948,1006,Block 1006,205,33.8386861,-84.3771657,205,176,29,176,130,30,0,9,0,2,5
4040,136953,1011,Block 1011,358,33.8376103,-84.3786921,358,314,44,314,238,51,0,17,0,3,5
4041,136955,1013,Block 1013,226,33.8375643,-84.3758794,226,212,14,212,142,54,0,7,0,2,7
4042,136956,1014,Block 1014,164,33.8374896,-84.3743286,164,149,15,149,84,47,0,8,0,6,4
4043,136957,1015,Block 1015,236,33.8376538,-84.3722937,236,218,18,218,183,30,0,2,0,0,3
4044,136961,2000,Block 2000,93,33.8337709,-84.3799056,93,85,8,85,56,15,1,1,0,10,2
4045,136963,2002,Block 2002,197,33.832212,-84.3770678,197,167,30,167,145,12,2,2,0,1,5
4046,136964,2003,Block 2003,180,33.8328762,-84.3817962,180,114,66,114,92,11,0,7,0,3,1
4047,136965,2004,Block 2004,64,33.8319086,-84.3845082,64,56,8,56,35,20,0,1,0,0,0
4048,136966,2005,Block 2005,329,33.8299182,-84.3851251,329,244,85,244,187,28,1,8,0,7,13
4049,136967,2006,Block 2006,46,33.8302762,-84.3809018,46,45,1,45,44,0,0,1,0,0,0
4050,136968,2007,Block 2007,52,33.829215,-84.3813074,52,51,1,51,48,0,0,2,0,0,1
4051,136970,3000,Block 3000,37,33.8350874,-84.3712415,37,37,0,37,37,0,0,0,0,0,0
4052,136971,3001,Block 3001,46,33.8339307,-84.3741353,46,45,1,45,38,4,0,1,0,2,0
4053,136972,3002,Block 3002,42,33.8359815,-84.3756119,42,36,6,36,33,3,0,0,0,0,0
4054,136973,3003,Block 3003,15,33.8358942,-84.3770976,15,12,3,12,12,0,0,0,0,0,0
4055,136974,3004,Block 3004,260,33.8358798,-84.3798587,260,194,66,194,63,38,0,21,0,66,6
4056,136975,3005,Block 3005,32,33.8338103,-84.3770765,32,25,7,25,23,0,0,0,0,0,2
4057,136976,3006,Block 3006,32,33.8339424,-84.3755235,32,31,1,31,28,0,0,2,0,0,1
4058,136977,3007,Block 3007,28,33.8325105,-84.3711482,28,26,2,26,26,0,0,0,0,0,0
4059,136978,3008,Block 3008,35,33.8326279,-84.3691475,35,24,11,24,21,1,0,0,0,0,2
4060,136979,3009,Block 3009,16,33.8305927,-84.3717753,16,15,1,15,15,0,0,0,0,0,0
4061,136980,3010,Block 3010,32,33.8307372,-84.374389,32,30,2,30,29,1,0,0,0,0,0
4062,136982,3012,Block 3012,26,33.829259,-84.3755501,26,24,2,24,24,0,0,0,0,0,0
4063,136983,3013,Block 3013,17,33.8292727,-84.3721819,17,17,0,17,15,0,1,0,0,0,1
4064,136984,3014,Block 3014,18,33.8291756,-84.3703061,18,18,0,18,18,0,0,0,0,0,0
4065,136985,3015,Block 3015,20,33.8305624,-84.3703202,20,19,1,19,17,0,0,2,0,0,0
4066,136986,3016,Block 3016,7,33.8305901,-84.3683896,7,6,1,6,6,0,0,0,0,0,0
4067,136991,1002,Block 1002,34,33.8598625,-84.4379575,34,33,1,33,32,1,0,0,0,0,0
4068,136992,1003,Block 1003,27,33.8551103,-84.4361648,27,22,5,22,19,1,0,0,0,1,1
4069,136993,1004,Block 1004,265,33.8620424,-84.4476752,265,225,40,225,184,28,0,8,0,3,2
4070,136998,1009,Block 1009,12,33.8649681,-84.4519978,12,9,3,9,9,0,0,0,0,0,0
4071,137001,1012,Block 1012,37,33.8635822,-84.4539865,37,31,6,31,30,0,0,1,0,0,0
4072,137004,1015,Block 1015,24,33.8501175,-84.4392794,24,24,0,24,24,0,0,0,0,0,0
4073,137005,1016,Block 1016,26,33.8581825,-84.4414055,26,23,3,23,20,3,0,0,0,0,0
4074,137007,1018,Block 1018,39,33.850932,-84.4323587,39,38,1,38,38,0,0,0,0,0,0
4075,137010,1021,Block 1021,8,33.8554389,-84.4421251,8,8,0,8,8,0,0,0,0,0,0
4076,137011,1022,Block 1022,24,33.8558914,-84.4469877,24,21,3,21,18,1,0,2,0,0,0
4077,137015,1026,Block 1026,23,33.8478671,-84.4357667,23,22,1,22,21,1,0,0,0,0,0
4078,137017,1028,Block 1028,1,33.8477909,-84.4346635,1,1,0,1,1,0,0,0,0,0,0
4079,137019,2000,Block 2000,33,33.8482962,-84.4440792,33,30,3,30,28,2,0,0,0,0,0
4080,137020,2001,Block 2001,56,33.8539835,-84.4548572,56,53,3,53,49,2,0,2,0,0,0
4081,137023,2004,Block 2004,32,33.8422689,-84.4438684,32,27,5,27,26,0,0,1,0,0,0
4082,137025,2006,Block 2006,12,33.8428018,-84.4391725,12,10,2,10,10,0,0,0,0,0,0
4083,137027,2008,Block 2008,90,33.8414573,-84.4342078,90,83,7,83,74,7,0,1,0,0,1
4084,137029,2010,Block 2010,2,33.8377816,-84.4301048,2,2,0,2,0,2,0,0,0,0,0
4085,137032,2013,Block 2013,48,33.8359576,-84.4302815,48,46,2,46,43,3,0,0,0,0,0
4086,137033,2014,Block 2014,32,33.8415026,-84.4525454,32,30,2,30,28,1,0,1,0,0,0
4087,137034,2015,Block 2015,24,33.8323219,-84.4291375,24,24,0,24,21,2,0,1,0,0,0
4088,137036,2017,Block 2017,10,33.8389727,-84.4483289,10,10,0,10,10,0,0,0,0,0,0
4089,137037,2018,Block 2018,17,33.8384254,-84.451366,17,15,2,15,15,0,0,0,0,0,0
4090,137038,2019,Block 2019,19,33.8298388,-84.4281034,19,17,2,17,17,0,0,0,0,0,0
4091,137043,2024,Block 2024,21,33.8273155,-84.4270645,21,19,2,19,18,0,0,1,0,0,0
4092,137044,2025,Block 2025,8,33.8247473,-84.4273579,8,8,0,8,6,2,0,0,0,0,0
4093,137050,2031,Block 2031,21,33.838564,-84.4448419,21,21,0,21,20,0,0,0,0,0,1
4094,137052,3000,Block 3000,107,33.8321505,-84.4514026,107,97,10,97,94,1,0,2,0,0,0
4095,137053,3001,Block 3001,1,33.8376047,-84.4582404,1,1,0,1,1,0,0,0,0,0,0
4096,137055,3003,Block 3003,16,33.837523,-84.4536698,16,16,0,16,15,0,0,1,0,0,0
4097,137056,3004,Block 3004,6,33.8446195,-84.4561437,6,6,0,6,5,1,0,0,0,0,0
4098,137061,3009,Block 3009,10,33.8372229,-84.4387278,10,10,0,10,10,0,0,0,0,0,0
4099,137062,3010,Block 3010,36,33.8357165,-84.4360608,36,32,4,32,28,2,0,2,0,0,0
4100,137063,3011,Block 3011,23,33.8342886,-84.4337936,23,19,4,19,18,0,0,1,0,0,0
4101,137064,3012,Block 3012,27,33.8343137,-84.4379944,27,27,0,27,24,1,0,2,0,0,0
4102,137065,3013,Block 3013,23,33.8342619,-84.4414973,23,23,0,23,23,0,0,0,0,0,0
4103,137066,3014,Block 3014,76,33.8308959,-84.4346867,76,75,1,75,69,3,0,3,0,0,0
4104,137068,3016,Block 3016,13,33.8319114,-84.4362365,13,11,2,11,11,0,0,0,0,0,0
4105,137069,3017,Block 3017,67,33.8282095,-84.4335495,67,66,1,66,66,0,0,0,0,0,0
4106,137070,3018,Block 3018,11,33.8264729,-84.4304224,11,11,0,11,10,1,0,0,0,0,0
4107,137071,3019,Block 3019,48,33.8266885,-84.437546,48,43,5,43,40,0,0,3,0,0,0
4108,137074,3022,Block 3022,14,33.8275673,-84.4407834,14,13,1,13,11,0,0,1,0,1,0
4109,137075,3023,Block 3023,40,33.8298089,-84.4419385,40,38,2,38,32,3,0,1,0,0,2
4110,137076,3024,Block 3024,25,33.8319744,-84.439843,25,24,1,24,23,0,0,1,0,0,0
4111,137077,3025,Block 3025,38,33.8341871,-84.4456608,38,36,2,36,34,1,0,1,0,0,0
4112,137078,3026,Block 3026,6,33.8322341,-84.4479011,6,6,0,6,6,0,0,0,0,0,0
4113,137079,3027,Block 3027,10,33.8237511,-84.430539,10,8,2,8,8,0,0,0,0,0,0
4114,137083,3031,Block 3031,5,33.8258142,-84.4408645,5,5,0,5,5,0,0,0,0,0,0
4115,137089,1003,Block 1003,286,33.8397406,-84.428284,286,269,17,269,259,8,0,2,0,0,0
4116,137090,1004,Block 1004,62,33.8381505,-84.4259951,62,62,0,62,59,0,0,3,0,0,0
4117,137092,1006,Block 1006,402,33.8415076,-84.4238954,402,374,28,374,340,18,0,12,0,0,4
4118,137094,1008,Block 1008,34,33.8332574,-84.4221463,34,33,1,33,32,0,0,0,0,0,1
4119,137095,1009,Block 1009,77,33.8391503,-84.4145464,77,76,1,76,74,1,0,1,0,0,0
4120,137096,1010,Block 1010,42,33.8354349,-84.4144961,42,41,1,41,41,0,0,0,0,0,0
4121,137097,1011,Block 1011,25,33.8382912,-84.4104453,25,24,1,24,23,1,0,0,0,0,0
4122,137098,1012,Block 1012,6,33.8380102,-84.4086174,6,6,0,6,6,0,0,0,0,0,0
4123,137100,1014,Block 1014,64,33.836356,-84.4242627,64,60,4,60,59,1,0,0,0,0,0
4124,137101,1015,Block 1015,30,33.8383245,-84.4197132,30,27,3,27,26,0,0,1,0,0,0
4125,137102,1016,Block 1016,13,33.833816,-84.4127496,13,12,1,12,11,0,0,1,0,0,0
4126,137104,2000,Block 2000,62,33.8460081,-84.4106945,62,59,3,59,57,1,0,1,0,0,0
4127,137105,2001,Block 2001,1,33.8448266,-84.409931,1,1,0,1,0,0,0,1,0,0,0
4128,137106,2002,Block 2002,80,33.8460586,-84.4174564,80,74,6,74,72,1,0,1,0,0,0
4129,137107,2003,Block 2003,79,33.8464087,-84.4209294,79,76,3,76,73,2,0,1,0,0,0
4130,137109,2005,Block 2005,89,33.847074,-84.4259405,89,87,2,87,85,1,0,1,0,0,0
4131,137111,2007,Block 2007,10,33.8481161,-84.4258226,10,10,0,10,10,0,0,0,0,0,0
4132,137113,2009,Block 2009,14,33.8488004,-84.4244526,14,14,0,14,14,0,0,0,0,0,0
4133,137114,2010,Block 2010,97,33.8415161,-84.4104582,97,87,10,87,86,1,0,0,0,0,0
4134,137115,2011,Block 2011,24,33.842133,-84.4141519,24,23,1,23,22,0,0,0,0,1,0
4135,137116,2012,Block 2012,56,33.8437163,-84.4152033,56,53,3,53,51,0,0,1,0,0,1
4136,137118,3000,Block 3000,16,33.836359,-84.4086678,16,15,1,15,13,0,0,0,0,1,1
4137,137119,3001,Block 3001,1,33.8364051,-84.4105167,1,1,0,1,0,0,0,0,0,0,1
4138,137120,3002,Block 3002,16,33.8344426,-84.4108579,16,16,0,16,16,0,0,0,0,0,0
4139,137121,3003,Block 3003,23,33.8337,-84.4094578,23,23,0,23,23,0,0,0,0,0,0
4140,137122,3004,Block 3004,32,33.8311656,-84.4082659,32,31,1,31,31,0,0,0,0,0,0
4141,137123,3005,Block 3005,20,33.831839,-84.4105639,20,19,1,19,17,1,0,1,0,0,0
4142,137125,3007,Block 3007,13,33.8322017,-84.41344,13,13,0,13,13,0,0,0,0,0,0
4143,137126,3008,Block 3008,5,33.8307952,-84.415651,5,5,0,5,5,0,0,0,0,0,0
4144,137127,3009,Block 3009,6,33.8310751,-84.4176835,6,6,0,6,6,0,0,0,0,0,0
4145,137129,3011,Block 3011,30,33.8294583,-84.4179953,30,30,0,30,29,0,0,1,0,0,0
4146,137130,3012,Block 3012,17,33.829637,-84.4210233,17,17,0,17,16,0,0,1,0,0,0
4147,137131,3013,Block 3013,28,33.8301465,-84.4127186,28,27,1,27,26,0,0,0,0,0,1
4148,137132,3014,Block 3014,12,33.8295362,-84.4108316,12,12,0,12,12,0,0,0,0,0,0
4149,137133,3015,Block 3015,37,33.82659,-84.4129578,37,37,0,37,36,0,1,0,0,0,0
4150,137135,3017,Block 3017,72,33.82698,-84.4201977,72,71,1,71,69,0,0,2,0,0,0
4151,137136,3018,Block 3018,1,33.8272189,-84.4208635,1,1,0,1,1,0,0,0,0,0,0
4152,137138,3020,Block 3020,22,33.824985,-84.422139,22,22,0,22,21,0,0,0,0,0,1
4153,137139,3021,Block 3021,17,33.8236376,-84.4191635,17,15,2,15,15,0,0,0,0,0,0
4154,137140,3022,Block 3022,21,33.8224386,-84.4090519,21,20,1,20,20,0,0,0,0,0,0
4155,137141,3023,Block 3023,18,33.8262976,-84.4090519,18,17,1,17,17,0,0,0,0,0,0
4156,137143,3025,Block 3025,11,33.8263694,-84.4079897,11,9,2,9,7,0,0,2,0,0,0
4157,137144,3026,Block 3026,28,33.8219731,-84.4112308,28,25,3,25,25,0,0,0,0,0,0
4158,137151,1000,Block 1000,16,33.8687929,-84.4103297,16,16,0,16,15,1,0,0,0,0,0
4159,137152,1001,Block 1001,18,33.8671001,-84.4082675,18,18,0,18,18,0,0,0,0,0,0
4160,137153,1002,Block 1002,4,33.8693591,-84.4081361,4,4,0,4,4,0,0,0,0,0,0
4161,137154,1003,Block 1003,6,33.8651967,-84.4105022,6,6,0,6,6,0,0,0,0,0,0
4162,137155,1004,Block 1004,42,33.8626406,-84.4177974,42,40,2,40,38,2,0,0,0,0,0
4163,137156,1005,Block 1005,15,33.8648734,-84.4074072,15,14,1,14,14,0,0,0,0,0,0
4164,137158,1007,Block 1007,10,33.8618246,-84.4106451,10,9,1,9,9,0,0,0,0,0,0
4165,137159,1008,Block 1008,44,33.86068,-84.4294542,44,43,1,43,36,5,0,1,0,0,1
4166,137164,1013,Block 1013,51,33.8595958,-84.4160118,51,51,0,51,49,0,0,2,0,0,0
4167,137165,1014,Block 1014,20,33.8544445,-84.4130505,20,19,1,19,19,0,0,0,0,0,0
4168,137166,1015,Block 1015,22,33.854304,-84.4147852,22,21,1,21,19,0,0,2,0,0,0
4169,137167,1016,Block 1016,1,33.8611549,-84.4171726,1,1,0,1,0,0,0,1,0,0,0
4170,137168,1017,Block 1017,83,33.8561455,-84.4197125,83,78,5,78,74,1,0,2,0,1,0
4171,137169,1018,Block 1018,14,33.8587487,-84.4208533,14,14,0,14,14,0,0,0,0,0,0
4172,137170,1019,Block 1019,1,33.8528289,-84.4199667,1,1,0,1,1,0,0,0,0,0,0
4173,137171,1020,Block 1020,11,33.8571506,-84.4237668,11,9,2,9,9,0,0,0,0,0,0
4174,137172,1021,Block 1021,1,33.8565419,-84.4268672,1,1,0,1,0,0,0,0,0,1,0
4175,137173,1022,Block 1022,24,33.8549647,-84.4255232,24,23,1,23,22,0,0,1,0,0,0
4176,137174,1023,Block 1023,1,33.8551837,-84.4248872,1,1,0,1,1,0,0,0,0,0,0
4177,137175,1024,Block 1024,1,33.8555572,-84.4269669,1,1,0,1,1,0,0,0,0,0,0
4178,137176,1025,Block 1025,32,33.8529826,-84.4163642,32,32,0,32,32,0,0,0,0,0,0
4179,137177,1026,Block 1026,8,33.8502292,-84.4125671,8,8,0,8,8,0,0,0,0,0,0
4180,137178,1027,Block 1027,24,33.8518865,-84.40958,24,22,2,22,22,0,0,0,0,0,0
4181,137180,1029,Block 1029,17,33.8573171,-84.4065945,17,16,1,16,15,0,0,1,0,0,0
4182,137183,1032,Block 1032,61,33.8522538,-84.4256318,61,57,4,57,55,0,0,2,0,0,0
4183,137184,1033,Block 1033,45,33.852139,-84.4290308,45,42,3,42,40,0,0,2,0,0,0
4184,137185,1034,Block 1034,4,33.8497057,-84.4291493,4,4,0,4,4,0,0,0,0,0,0
4185,137186,1035,Block 1035,9,33.8486494,-84.4084291,9,8,1,8,8,0,0,0,0,0,0
4186,137188,2002,Block 2002,24,33.8774318,-84.4293832,24,23,1,23,22,1,0,0,0,0,0
4187,137190,2007,Block 2007,90,33.8732408,-84.4223321,90,84,6,84,75,2,0,6,0,0,1
4188,137191,2009,Block 2009,37,33.8759629,-84.4157709,37,35,2,35,28,2,0,4,0,0,1
4189,137192,2011,Block 2011,4,33.8741004,-84.4277982,4,3,1,3,3,0,0,0,0,0,0
4190,137193,2012,Block 2012,75,33.8727631,-84.4295875,75,70,5,70,65,2,0,2,0,1,0
4191,137195,2014,Block 2014,42,33.8716934,-84.4359605,42,39,3,39,34,3,0,1,0,0,1
4192,137196,2015,Block 2015,44,33.8752819,-84.4404866,44,44,0,44,42,1,0,1,0,0,0
4193,137198,2019,Block 2019,28,33.8647991,-84.433824,28,28,0,28,25,2,0,1,0,0,0
4194,137199,2020,Block 2020,37,33.8639506,-84.4361645,37,34,3,34,32,0,0,1,0,0,1
4195,137200,2021,Block 2021,34,33.8698927,-84.4410066,34,28,6,28,22,5,0,0,0,0,1
4196,137201,2022,Block 2022,17,33.8727422,-84.441634,17,17,0,17,17,0,0,0,0,0,0
4197,137206,2028,Block 2028,169,33.869768,-84.4171346,169,152,17,152,144,3,0,4,0,1,0
4198,137213,2035,Block 2035,106,33.8683728,-84.4509025,106,94,12,94,70,10,0,12,0,1,1
4199,137214,2036,Block 2036,190,33.8676969,-84.4499359,190,163,27,163,141,11,1,6,0,2,2
4200,137216,2038,Block 2038,497,33.8701479,-84.4477604,497,433,64,433,347,49,0,34,0,0,3
4201,137222,1000,Block 1000,379,33.8750007,-84.3835424,379,346,33,346,298,28,1,10,1,3,5
4202,137223,1001,Block 1001,18,33.8739057,-84.3836799,18,17,1,17,15,1,0,0,0,0,1
4203,137224,1002,Block 1002,4,33.8718636,-84.3832512,4,3,1,3,3,0,0,0,0,0,0
4204,137226,1004,Block 1004,17,33.8729671,-84.385745,17,17,0,17,16,0,0,1,0,0,0
4205,137227,1005,Block 1005,19,33.8715668,-84.3859438,19,19,0,19,18,1,0,0,0,0,0
4206,137228,1006,Block 1006,80,33.8697521,-84.384679,80,72,8,72,67,4,0,0,0,1,0
4207,137229,1007,Block 1007,9,33.8704167,-84.3819224,9,9,0,9,8,0,0,1,0,0,0
4208,137230,1008,Block 1008,24,33.8703503,-84.3825838,24,23,1,23,22,0,0,1,0,0,0
4209,137231,1009,Block 1009,14,33.8703865,-84.3832578,14,13,1,13,12,0,0,1,0,0,0
4210,137232,1010,Block 1010,9,33.8702831,-84.3836872,9,7,2,7,7,0,0,0,0,0,0
4211,137233,1011,Block 1011,382,33.8675953,-84.3840982,382,337,45,337,295,23,0,10,0,1,8
4212,137235,1013,Block 1013,131,33.8659166,-84.3830082,131,119,12,119,100,6,0,10,0,1,2
4213,137237,1015,Block 1015,15,33.8649406,-84.3894169,15,15,0,15,15,0,0,0,0,0,0
4214,137238,1016,Block 1016,46,33.8644943,-84.3842546,46,43,3,43,41,2,0,0,0,0,0
4215,137240,2000,Block 2000,36,33.861996,-84.3844884,36,36,0,36,36,0,0,0,0,0,0
4216,137241,2001,Block 2001,9,33.863242,-84.3842498,9,9,0,9,9,0,0,0,0,0,0
4217,137242,2002,Block 2002,136,33.8589125,-84.3829521,136,104,32,104,79,14,0,10,0,1,0
4218,137243,2003,Block 2003,16,33.8597943,-84.3854867,16,15,1,15,15,0,0,0,0,0,0
4219,137244,2004,Block 2004,64,33.8613353,-84.3918503,64,60,4,60,58,0,0,1,0,1,0
4220,137246,2006,Block 2006,46,33.8639598,-84.3964508,46,41,5,41,40,0,0,0,1,0,0
4221,137247,2007,Block 2007,31,33.8610265,-84.3996649,31,27,4,27,24,1,0,2,0,0,0
4222,137248,2008,Block 2008,33,33.8574965,-84.390286,33,32,1,32,31,0,0,0,0,0,1
4223,137249,2009,Block 2009,9,33.8554716,-84.3885668,9,8,1,8,8,0,0,0,0,0,0
4224,137250,2010,Block 2010,39,33.8570436,-84.3864335,39,36,3,36,36,0,0,0,0,0,0
4225,137251,2011,Block 2011,123,33.8533045,-84.3895516,123,108,15,108,98,2,0,8,0,0,0
4226,137252,2012,Block 2012,14,33.852414,-84.3855833,14,12,2,12,12,0,0,0,0,0,0
4227,137254,3000,Block 3000,15,33.8590445,-84.3983563,15,15,0,15,15,0,0,0,0,0,0
4228,137255,3001,Block 3001,19,33.8577618,-84.3985926,19,18,1,18,18,0,0,0,0,0,0
4229,137256,3002,Block 3002,36,33.8555787,-84.4011025,36,34,2,34,34,0,0,0,0,0,0
4230,137257,3003,Block 3003,41,33.8505564,-84.3932816,41,39,2,39,39,0,0,0,0,0,0
4231,137258,3004,Block 3004,46,33.8498894,-84.397154,46,42,4,42,40,0,0,2,0,0,0
4232,137259,3005,Block 3005,46,33.8497667,-84.4014933,46,41,5,41,40,0,0,1,0,0,0
4233,137260,3006,Block 3006,20,33.85183,-84.406111,20,19,1,19,18,0,0,1,0,0,0
4234,137261,3007,Block 3007,25,33.8445429,-84.4034745,25,24,1,24,24,0,0,0,0,0,0
4235,137262,3008,Block 3008,6,33.845913,-84.4064394,6,5,1,5,5,0,0,0,0,0,0
4236,137263,3009,Block 3009,36,33.838679,-84.4072926,36,34,2,34,32,1,0,1,0,0,0
4237,137264,3010,Block 3010,34,33.8408353,-84.4060872,34,31,3,31,31,0,0,0,0,0,0
4238,137265,3011,Block 3011,31,33.841233,-84.4046281,31,29,2,29,28,0,0,0,0,0,1
4239,137266,3012,Block 3012,78,33.8415034,-84.4015433,78,74,4,74,72,2,0,0,0,0,0
4240,137270,4000,Block 4000,47,33.869519,-84.4045165,47,44,3,44,44,0,0,0,0,0,0
4241,137272,4002,Block 4002,5,33.8724763,-84.4023559,5,4,1,4,4,0,0,0,0,0,0
4242,137273,4003,Block 4003,33,33.8725778,-84.4053287,33,32,1,32,32,0,0,0,0,0,0
4243,137274,4004,Block 4004,24,33.8669545,-84.4039095,24,24,0,24,24,0,0,0,0,0,0
4244,137275,4005,Block 4005,47,33.8690408,-84.3992979,47,46,1,46,44,1,0,1,0,0,0
4245,137276,4006,Block 4006,50,33.8691426,-84.3944603,50,48,2,48,48,0,0,0,0,0,0
4246,137277,4007,Block 4007,50,33.8711519,-84.3981266,50,49,1,49,45,1,0,3,0,0,0
4247,137282,4012,Block 4012,13,33.8646679,-84.4013344,13,12,1,12,11,0,0,1,0,0,0
4248,137283,4013,Block 4013,23,33.866171,-84.3968426,23,21,2,21,21,0,0,0,0,0,0
4249,137289,1003,Block 1003,15,33.8497811,-84.3684414,15,14,1,14,11,3,0,0,0,0,0
4250,137293,1007,Block 1007,583,33.8478933,-84.3708327,583,387,196,387,268,52,0,51,2,6,8
4251,137294,1008,Block 1008,120,33.8527156,-84.3746,120,109,11,109,106,1,0,2,0,0,0
4252,137295,1009,Block 1009,51,33.854736,-84.3739135,51,48,3,48,48,0,0,0,0,0,0
4253,137296,1010,Block 1010,4,33.8563697,-84.3725044,4,4,0,4,4,0,0,0,0,0,0
4254,137297,1011,Block 1011,1,33.8525985,-84.3727773,1,1,0,1,1,0,0,0,0,0,0
4255,137298,1012,Block 1012,183,33.8536493,-84.3804646,183,169,14,169,124,36,0,5,0,0,4
4256,137299,1013,Block 1013,90,33.8540275,-84.3817059,90,90,0,90,42,32,0,13,0,1,2
4257,137300,1014,Block 1014,12,33.856513,-84.375052,12,12,0,12,12,0,0,0,0,0,0
4258,137302,2000,Block 2000,37,33.8751041,-84.378398,37,32,5,32,31,0,0,0,0,1,0
4259,137303,2001,Block 2001,100,33.8733271,-84.3789551,100,93,7,93,86,3,0,2,0,0,2
4260,137304,2002,Block 2002,14,33.873527,-84.3765642,14,10,4,10,9,0,0,1,0,0,0
4261,137305,2003,Block 2003,14,33.8714207,-84.3767002,14,13,1,13,13,0,0,0,0,0,0
4262,137307,2005,Block 2005,30,33.8686243,-84.38025,30,26,4,26,24,2,0,0,0,0,0
4263,137308,2006,Block 2006,20,33.8712095,-84.3794839,20,18,2,18,16,2,0,0,0,0,0
4264,137312,2010,Block 2010,56,33.8703043,-84.3748096,56,53,3,53,45,5,0,1,0,1,1
4265,137314,2012,Block 2012,36,33.867958,-84.3709907,36,34,2,34,28,1,1,3,0,0,1
4266,137315,2013,Block 2013,25,33.8664636,-84.3698936,25,25,0,25,20,1,0,2,0,0,2
4267,137316,2014,Block 2014,47,33.8668709,-84.378415,47,44,3,44,42,1,0,0,0,1,0
4268,137317,2015,Block 2015,21,33.868074,-84.3750494,21,20,1,20,19,0,0,0,0,1,0
4269,137318,2016,Block 2016,47,33.8667187,-84.3755128,47,45,2,45,41,0,1,1,0,0,2
4270,137327,3010,Block 3010,70,33.8726698,-84.3669188,70,67,3,67,64,2,0,1,0,0,0
4271,137328,3011,Block 3011,6,33.8696327,-84.3708863,6,6,0,6,6,0,0,0,0,0,0
4272,137329,3012,Block 3012,16,33.871254,-84.3676782,16,16,0,16,16,0,0,0,0,0,0
4273,137330,3013,Block 3013,28,33.8767093,-84.366082,28,28,0,28,23,4,0,1,0,0,0
4274,137332,3017,Block 3017,42,33.873213,-84.3727028,42,39,3,39,33,1,0,4,0,0,1
4275,137333,3018,Block 3018,15,33.8750066,-84.3720884,15,15,0,15,15,0,0,0,0,0,0
4276,137334,3019,Block 3019,20,33.8749468,-84.3679945,20,17,3,17,15,0,0,1,0,1,0
4277,137335,3020,Block 3020,25,33.8744989,-84.370036,25,24,1,24,24,0,0,0,0,0,0
4278,137339,4000,Block 4000,221,33.8620694,-84.3749943,221,210,11,210,164,16,3,2,0,22,3
4279,137342,4003,Block 4003,34,33.8616904,-84.3776605,34,32,2,32,31,0,0,1,0,0,0
4280,137343,4004,Block 4004,29,33.8603992,-84.3703491,29,28,1,28,26,2,0,0,0,0,0
4281,137344,4005,Block 4005,22,33.8630462,-84.371646,22,22,0,22,22,0,0,0,0,0,0
4282,137345,4006,Block 4006,525,33.857716,-84.3793013,525,475,50,475,363,78,2,20,0,4,8
4283,137350,1010,Block 1010,70,33.8773118,-84.3554748,70,68,2,68,64,2,0,2,0,0,0
4284,137351,1011,Block 1011,17,33.8790036,-84.3528095,17,17,0,17,17,0,0,0,0,0,0
4285,137352,1012,Block 1012,16,33.8802131,-84.3507418,16,16,0,16,16,0,0,0,0,0,0
4286,137354,1014,Block 1014,31,33.8779614,-84.3506336,31,29,2,29,29,0,0,0,0,0,0
4287,137355,1015,Block 1015,61,33.8746968,-84.352741,61,55,6,55,53,0,0,1,0,1,0
4288,137357,1017,Block 1017,23,33.8754916,-84.3556386,23,21,2,21,21,0,0,0,0,0,0
4289,137359,1019,Block 1019,47,33.8702624,-84.3568963,47,45,2,45,42,1,0,2,0,0,0
4290,137361,1021,Block 1021,14,33.8712401,-84.3552394,14,14,0,14,14,0,0,0,0,0,0
4291,137362,1022,Block 1022,18,33.8690591,-84.3549893,18,18,0,18,17,1,0,0,0,0,0
4292,137364,1024,Block 1024,22,33.8710893,-84.350406,22,21,1,21,21,0,0,0,0,0,0
4293,137365,1025,Block 1025,25,33.8716922,-84.3524817,25,25,0,25,24,0,0,1,0,0,0
4294,137367,1027,Block 1027,33,33.8734752,-84.3489839,33,33,0,33,33,0,0,0,0,0,0
4295,137368,1028,Block 1028,5,33.8662748,-84.3554896,5,5,0,5,5,0,0,0,0,0,0
4296,137369,1029,Block 1029,11,33.8650584,-84.3561954,11,11,0,11,11,0,0,0,0,0,0
4297,137370,1030,Block 1030,16,33.8680492,-84.3577716,16,12,4,12,12,0,0,0,0,0,0
4298,137371,1031,Block 1031,2,33.8646776,-84.3508043,2,1,1,1,1,0,0,0,0,0,0
4299,137375,2003,Block 2003,75,33.8756642,-84.3613862,75,74,1,74,66,5,0,3,0,0,0
4300,137376,2004,Block 2004,2,33.8778103,-84.3588493,2,2,0,2,2,0,0,0,0,0,0
4301,137377,2005,Block 2005,19,33.8731952,-84.3593993,19,14,5,14,14,0,0,0,0,0,0
4302,137378,2006,Block 2006,55,33.8706304,-84.3612863,55,53,2,53,49,2,0,1,0,0,1
4303,137379,2007,Block 2007,29,33.8703311,-84.3638487,29,28,1,28,28,0,0,0,0,0,0
4304,137380,2008,Block 2008,4,33.8671728,-84.3618238,4,4,0,4,4,0,0,0,0,0,0
4305,137381,2009,Block 2009,33,33.8694591,-84.3596983,33,32,1,32,30,2,0,0,0,0,0
4306,137382,2010,Block 2010,27,33.8670604,-84.3592647,27,27,0,27,25,2,0,0,0,0,0
4307,137383,2011,Block 2011,52,33.864133,-84.3612032,52,46,6,46,43,1,0,2,0,0,0
4308,137384,2012,Block 2012,1,33.8666704,-84.3621899,1,1,0,1,1,0,0,0,0,0,0
4309,137385,2013,Block 2013,8,33.8670382,-84.364086,8,8,0,8,6,2,0,0,0,0,0
4310,137386,2014,Block 2014,7,33.8677118,-84.3636541,7,7,0,7,7,0,0,0,0,0,0
4311,137387,2015,Block 2015,40,33.8659552,-84.3661823,40,39,1,39,35,0,0,2,0,0,2
4312,137388,2016,Block 2016,15,33.865035,-84.3676655,15,14,1,14,14,0,0,0,0,0,0
4313,137389,2017,Block 2017,39,33.8609722,-84.3673319,39,35,4,35,35,0,0,0,0,0,0
4314,137391,2019,Block 2019,19,33.862264,-84.364274,19,17,2,17,16,1,0,0,0,0,0
4315,137392,2020,Block 2020,20,33.8651493,-84.3649055,20,17,3,17,16,1,0,0,0,0,0
4316,137393,2021,Block 2021,36,33.8645138,-84.3634533,36,35,1,35,34,1,0,0,0,0,0
4317,137394,2022,Block 2022,3,33.8656599,-84.3584662,3,3,0,3,2,0,0,1,0,0,0
4318,137395,2023,Block 2023,13,33.8639928,-84.3588852,13,13,0,13,12,1,0,0,0,0,0
4319,137397,3000,Block 3000,27,33.8636102,-84.352266,27,26,1,26,26,0,0,0,0,0,0
4320,137398,3001,Block 3001,46,33.861967,-84.3535188,46,42,4,42,41,1,0,0,0,0,0
4321,137399,3002,Block 3002,14,33.8631747,-84.3568567,14,14,0,14,13,0,0,0,0,0,1
4322,137400,3003,Block 3003,28,33.8600081,-84.3569398,28,26,2,26,26,0,0,0,0,0,0
4323,137401,3004,Block 3004,286,33.8583282,-84.3525403,286,257,29,257,255,2,0,0,0,0,0
4324,137403,3006,Block 3006,23,33.8590419,-84.3492841,23,21,2,21,21,0,0,0,0,0,0
4325,137404,3007,Block 3007,16,33.8613339,-84.3496943,16,15,1,15,15,0,0,0,0,0,0
4326,137405,3008,Block 3008,41,33.8566918,-84.3543174,41,28,13,28,28,0,0,0,0,0,0
4327,137406,3009,Block 3009,19,33.8568775,-84.3569295,19,16,3,16,15,0,0,0,0,0,1
4328,137407,3010,Block 3010,71,33.8582384,-84.3598168,71,68,3,68,57,7,0,3,0,1,0
4329,137409,3012,Block 3012,21,33.8607729,-84.3623142,21,18,3,18,18,0,0,0,0,0,0
4330,137410,3013,Block 3013,50,33.8589387,-84.3653679,50,38,12,38,35,1,0,1,0,0,1
4331,137412,3015,Block 3015,53,33.8567042,-84.3645028,53,48,5,48,42,2,0,3,0,0,1
4332,137413,3016,Block 3016,21,33.8564613,-84.3636558,21,19,2,19,19,0,0,0,0,0,0
4333,137414,3017,Block 3017,944,33.8546154,-84.3671176,944,683,261,683,527,97,2,47,0,0,10
4334,137415,3018,Block 3018,1,33.8542281,-84.3660432,1,1,0,1,1,0,0,0,0,0,0
4335,137416,3019,Block 3019,115,33.8551852,-84.3563425,115,99,16,99,87,11,0,0,0,0,1
4336,137418,3021,Block 3021,5,33.8548027,-84.3549042,5,3,2,3,2,0,0,1,0,0,0
4337,137422,3025,Block 3025,117,33.8529992,-84.3624988,117,84,33,84,79,2,0,3,0,0,0
4338,137423,3026,Block 3026,1,33.8548744,-84.361892,1,1,0,1,1,0,0,0,0,0,0
4339,137424,3027,Block 3027,593,33.8506845,-84.365951,593,425,168,425,291,69,0,49,0,4,12
4340,137426,3029,Block 3029,2,33.8562433,-84.3630546,2,1,1,1,0,0,0,1,0,0,0
4341,137430,2022,Block 2022,40,33.8763865,-84.3758819,40,34,6,34,25,6,0,2,0,1,0
4342,137431,2023,Block 2023,24,33.8775957,-84.3747713,24,24,0,24,24,0,0,0,0,0,0
4343,137436,1023,Block 1023,7,33.878437,-84.4390535,7,6,1,6,4,2,0,0,0,0,0
4344,137438,1029,Block 1029,2,33.8777739,-84.435523,2,1,1,1,1,0,0,0,0,0,0
4345,137441,1003,Block 1003,45,33.8838498,-84.4023868,45,44,1,44,42,0,0,2,0,0,0
4346,137442,1004,Block 1004,33,33.882133,-84.4054487,33,33,0,33,32,1,0,0,0,0,0
4347,137443,1009,Block 1009,39,33.875951,-84.408559,39,37,2,37,37,0,0,0,0,0,0
4348,137444,1010,Block 1010,64,33.8786894,-84.4042575,64,61,3,61,60,0,0,1,0,0,0
4349,137445,1011,Block 1011,13,33.881786,-84.4038977,13,13,0,13,13,0,0,0,0,0,0
4350,137446,1013,Block 1013,14,33.8801118,-84.3997552,14,14,0,14,14,0,0,0,0,0,0
4351,137447,1014,Block 1014,43,33.8786922,-84.4002514,43,42,1,42,40,2,0,0,0,0,0
4352,137448,1015,Block 1015,55,33.8758714,-84.4005757,55,52,3,52,51,0,0,1,0,0,0
4353,137449,1016,Block 1016,6,33.8756856,-84.4054969,6,5,1,5,5,0,0,0,0,0,0
4354,137452,2011,Block 2011,3,33.8777864,-84.3969033,3,3,0,3,3,0,0,0,0,0,0
4355,137453,2012,Block 2012,1,33.877824,-84.39328,1,1,0,1,0,0,0,1,0,0,0
4356,137454,2013,Block 2013,8,33.8780163,-84.3880642,8,8,0,8,7,0,0,1,0,0,0
4357,137455,2014,Block 2014,33,33.8825671,-84.3914705,33,32,1,32,31,0,0,1,0,0,0
4358,137457,2016,Block 2016,21,33.8821054,-84.3897581,21,20,1,20,20,0,0,0,0,0,0
4359,137462,2029,Block 2029,2,33.8749059,-84.3966441,2,2,0,2,2,0,0,0,0,0,0
4360,137465,2034,Block 2034,7,33.8777092,-84.3855161,7,6,1,6,5,0,0,0,0,0,1
4361,137468,1005,Block 1005,5,33.6956367,-84.5462804,5,3,2,3,0,3,0,0,0,0,0
4362,137469,1006,Block 1006,5,33.696618,-84.544405,5,3,2,3,0,3,0,0,0,0,0
4363,137470,1007,Block 1007,6,33.6951499,-84.5438826,6,3,3,3,0,2,0,0,0,0,1
4364,137471,1008,Block 1008,38,33.693037,-84.541961,38,35,3,35,0,35,0,0,0,0,0
4365,137472,1009,Block 1009,18,33.69167,-84.540092,18,16,2,16,0,16,0,0,0,0,0
4366,137473,1010,Block 1010,60,33.6937999,-84.5361171,60,47,13,47,0,47,0,0,0,0,0
4367,137474,1011,Block 1011,9,33.6943415,-84.5354887,9,6,3,6,0,6,0,0,0,0,0
4368,137475,1012,Block 1012,11,33.6918915,-84.5380758,11,8,3,8,0,8,0,0,0,0,0
4369,137476,1013,Block 1013,25,33.6913781,-84.5372791,25,23,2,23,0,23,0,0,0,0,0
4370,137477,1021,Block 1021,19,33.6880783,-84.5448424,19,17,2,17,0,16,0,1,0,0,0
4371,137478,1022,Block 1022,10,33.6898199,-84.5435966,10,10,0,10,0,10,0,0,0,0,0
4372,137479,1023,Block 1023,10,33.6908077,-84.543565,10,9,1,9,0,9,0,0,0,0,0
4373,137480,1024,Block 1024,5,33.690777,-84.5422511,5,5,0,5,0,5,0,0,0,0,0
4374,137481,1025,Block 1025,20,33.6907337,-84.540211,20,20,0,20,0,20,0,0,0,0,0
4375,137482,1026,Block 1026,11,33.6862862,-84.543641,11,11,0,11,0,11,0,0,0,0,0
4376,137483,1027,Block 1027,23,33.6879412,-84.5435302,23,22,1,22,0,22,0,0,0,0,0
4377,137484,1028,Block 1028,13,33.6883229,-84.5422646,13,13,0,13,0,13,0,0,0,0,0
4378,137485,1029,Block 1029,6,33.6897881,-84.5422834,6,6,0,6,0,6,0,0,0,0,0
4379,137486,1030,Block 1030,14,33.6897491,-84.5405678,14,10,4,10,0,10,0,0,0,0,0
4380,137487,1031,Block 1031,20,33.6880459,-84.5404978,20,16,4,16,0,16,0,0,0,0,0
4381,137488,1032,Block 1032,10,33.6887272,-84.54088,10,10,0,10,0,10,0,0,0,0,0
4382,137489,1033,Block 1033,43,33.68718,-84.5396614,43,39,4,39,1,36,0,0,0,0,2
4383,137490,1034,Block 1034,21,33.6863111,-84.5380358,21,17,4,17,0,17,0,0,0,0,0
4384,137491,1035,Block 1035,60,33.688909,-84.5352321,60,55,5,55,2,52,1,0,0,0,0
4385,137492,1036,Block 1036,47,33.6823655,-84.5420303,47,42,5,42,1,41,0,0,0,0,0
4386,137493,1037,Block 1037,19,33.6824506,-84.5399345,19,18,1,18,0,18,0,0,0,0,0
4387,137494,1038,Block 1038,20,33.6837507,-84.5394796,20,19,1,19,0,19,0,0,0,0,0
4388,137495,1039,Block 1039,11,33.6846675,-84.544351,11,11,0,11,0,11,0,0,0,0,0
4389,137497,1044,Block 1044,34,33.6875352,-84.537562,34,29,5,29,0,28,0,0,0,0,1
4390,137498,1045,Block 1045,21,33.688413,-84.5364202,21,20,1,20,0,20,0,0,0,0,0
4391,137499,1046,Block 1046,20,33.6836343,-84.5376265,20,19,1,19,0,19,0,0,0,0,0
4392,137500,1047,Block 1047,21,33.6851371,-84.537923,21,20,1,20,1,19,0,0,0,0,0
4393,137502,2025,Block 2025,267,33.7246817,-84.5455271,267,238,29,238,1,231,0,3,0,0,3
4394,137515,1000,Block 1000,12,33.7695925,-84.4093141,12,11,1,11,0,11,0,0,0,0,0
4395,137516,1001,Block 1001,31,33.7695975,-84.4105233,31,7,24,7,0,7,0,0,0,0,0
4396,137517,1002,Block 1002,39,33.7695999,-84.4118839,39,9,30,9,0,9,0,0,0,0,0
4397,137518,1003,Block 1003,30,33.7691419,-84.413035,30,11,19,11,0,10,0,0,0,0,1
4398,137519,1004,Block 1004,36,33.7691527,-84.4139939,36,12,24,12,1,11,0,0,0,0,0
4399,137520,1005,Block 1005,8,33.7677958,-84.4140103,8,5,3,5,0,5,0,0,0,0,0
4400,137521,1006,Block 1006,20,33.7677752,-84.413046,20,9,11,9,0,9,0,0,0,0,0
4401,137522,1007,Block 1007,6,33.7677629,-84.4118774,6,5,1,5,0,5,0,0,0,0,0
4402,137523,1008,Block 1008,12,33.7686736,-84.4118825,12,9,3,9,1,8,0,0,0,0,0
4403,137524,1009,Block 1009,28,33.7686775,-84.4105275,28,15,13,15,0,15,0,0,0,0,0
4404,137525,1010,Block 1010,5,33.768678,-84.4093264,5,2,3,2,0,1,0,0,0,0,1
4405,137526,1011,Block 1011,36,33.7677519,-84.4093433,36,10,26,10,0,10,0,0,0,0,0
4406,137527,1012,Block 1012,22,33.7677565,-84.4105325,22,16,6,16,0,16,0,0,0,0,0
4407,137529,2000,Block 2000,1509,33.7782711,-84.4145215,1509,797,712,797,177,537,1,21,0,15,46
4408,137533,2004,Block 2004,2,33.7746112,-84.4119093,2,2,0,2,0,1,0,0,0,0,1
4409,137543,2014,Block 2014,1,33.7735763,-84.4168967,1,1,0,1,0,1,0,0,0,0,0
4410,137544,2015,Block 2015,3,33.7735754,-84.4159296,3,2,1,2,0,2,0,0,0,0,0
4411,137546,2017,Block 2017,11,33.7735715,-84.4139273,11,6,5,6,2,4,0,0,0,0,0
4412,137549,2020,Block 2020,8,33.7726122,-84.4119257,8,2,6,2,0,2,0,0,0,0,0
4413,137550,2021,Block 2021,2,33.7726149,-84.4109802,2,1,1,1,0,0,0,0,0,1,0
4414,137563,2034,Block 2034,5,33.771743,-84.4119397,5,4,1,4,0,4,0,0,0,0,0
4415,137564,2035,Block 2035,23,33.7716957,-84.4109855,23,14,9,14,1,13,0,0,0,0,0
4416,137565,2036,Block 2036,42,33.7713209,-84.4099507,42,18,24,18,0,18,0,0,0,0,0
4417,137566,2037,Block 2037,3,33.7709718,-84.4108821,3,3,0,3,0,2,0,0,0,0,1
4418,137567,2038,Block 2038,20,33.7710171,-84.4118934,20,12,8,12,1,11,0,0,0,0,0
4419,137568,2039,Block 2039,20,33.7707003,-84.4130259,20,7,13,7,0,6,0,0,0,1,0
4420,137569,2040,Block 2040,23,33.7707053,-84.4139752,23,13,10,13,0,12,0,1,0,0,0
4421,137570,2041,Block 2041,14,33.7717524,-84.4139582,14,7,7,7,0,7,0,0,0,0,0
4422,137571,2042,Block 2042,8,33.7726101,-84.4139463,8,3,5,3,0,3,0,0,0,0,0
4423,137572,2043,Block 2043,5,33.7726139,-84.4149367,5,3,2,3,0,3,0,0,0,0,0
4424,137573,2044,Block 2044,10,33.7726178,-84.4159357,10,9,1,9,1,8,0,0,0,0,0
4425,137575,2046,Block 2046,53,33.7717829,-84.4169099,53,31,22,31,1,30,0,0,0,0,0
4426,137576,2047,Block 2047,19,33.771766,-84.4159497,19,18,1,18,2,15,0,0,0,0,1
4427,137577,2048,Block 2048,86,33.771135,-84.414966,86,17,69,17,0,17,0,0,0,0,0
4428,137578,2049,Block 2049,48,33.7707022,-84.415975,48,17,31,17,0,17,0,0,0,0,0
4429,137579,2050,Block 2050,19,33.771028,-84.4169283,19,15,4,15,0,15,0,0,0,0,0
4430,137580,2051,Block 2051,14,33.7703625,-84.4169343,14,12,2,12,0,12,0,0,0,0,0
4431,137581,2052,Block 2052,15,33.7703878,-84.4118801,15,10,5,10,0,9,0,0,0,0,1
4432,137582,2053,Block 2053,31,33.7703908,-84.4102669,31,16,15,16,1,15,0,0,0,0,0
4433,137591,3003,Block 3003,6,33.7695838,-84.405495,6,4,2,4,0,4,0,0,0,0,0
4434,137593,3005,Block 3005,2,33.7686718,-84.4069837,2,2,0,2,0,2,0,0,0,0,0
4435,137594,3006,Block 3006,4,33.7686626,-84.4055533,4,3,1,3,0,3,0,0,0,0,0
4436,137596,3008,Block 3008,1,33.7679001,-84.4069774,1,1,0,1,0,1,0,0,0,0,0
4437,137597,3009,Block 3009,37,33.7677505,-84.4082498,37,17,20,17,0,17,0,0,0,0,0
4438,137598,3010,Block 3010,3,33.7686796,-84.4082269,3,3,0,3,0,3,0,0,0,0,0
4439,137599,3011,Block 3011,265,33.7662053,-84.4061821,265,238,27,238,7,215,0,5,0,1,10
4440,137609,3021,Block 3021,11,33.7645868,-84.4057841,11,8,3,8,1,6,0,1,0,0,0
4441,137610,3022,Block 3022,13,33.7646029,-84.4070408,13,6,7,6,0,5,0,0,0,0,1
4442,137611,3023,Block 3023,42,33.7651446,-84.4082955,42,15,27,15,0,15,0,0,0,0,0
4443,137612,3024,Block 3024,31,33.7666566,-84.4082845,31,21,10,21,0,20,0,0,0,0,1
4444,137614,3026,Block 3026,10,33.7638465,-84.4057611,10,6,4,6,1,5,0,0,0,0,0
4445,137615,3027,Block 3027,10,33.7638469,-84.4070462,10,5,5,5,1,4,0,0,0,0,0
4446,137616,3028,Block 3028,7,33.7638438,-84.40831,7,3,4,3,0,3,0,0,0,0,0
4447,137622,1003,Block 1003,58,33.7531563,-84.3693217,58,43,15,43,4,35,0,0,0,0,4
4448,137623,1004,Block 1004,3,33.7540537,-84.3704994,3,3,0,3,3,0,0,0,0,0,0
4449,137624,1005,Block 1005,4,33.7536205,-84.3714833,4,1,3,1,1,0,0,0,0,0,0
4450,137625,1006,Block 1006,3,33.7540388,-84.3726906,3,3,0,3,2,1,0,0,0,0,0
4451,137626,1007,Block 1007,9,33.7540492,-84.3738188,9,8,1,8,5,3,0,0,0,0,0
4452,137627,1008,Block 1008,71,33.7540827,-84.3749594,71,61,10,61,16,43,0,2,0,0,0
4453,137628,1009,Block 1009,2,33.7540084,-84.376077,2,2,0,2,0,2,0,0,0,0,0
4454,137629,1010,Block 1010,11,33.7522889,-84.3708845,11,9,2,9,1,8,0,0,0,0,0
4455,137630,1011,Block 1011,76,33.7529861,-84.3702544,76,65,11,65,25,39,0,0,0,1,0
4456,137632,1013,Block 1013,203,33.7533193,-84.3669587,203,182,21,182,28,138,0,2,0,3,11
4457,137633,1014,Block 1014,14,33.7529374,-84.3681835,14,13,1,13,4,9,0,0,0,0,0
4458,137636,1017,Block 1017,37,33.7533291,-84.3736901,37,36,1,36,2,34,0,0,0,0,0
4459,137637,1018,Block 1018,262,33.7529321,-84.3723087,262,248,14,248,11,218,1,2,0,1,15
4460,137643,1024,Block 1024,9,33.7516931,-84.3745185,9,9,0,9,0,9,0,0,0,0,0
4461,137644,1025,Block 1025,18,33.7523883,-84.3732174,18,14,4,14,3,8,0,1,0,0,2
4462,137645,1026,Block 1026,7,33.7519498,-84.3736999,7,6,1,6,0,5,0,0,0,0,1
4463,137650,2000,Block 2000,1,33.7590386,-84.3851407,1,0,1,0,0,0,0,0,0,0,0
4464,137652,2002,Block 2002,1,33.7591102,-84.3883538,1,1,0,1,1,0,0,0,0,0,0
4465,137664,2014,Block 2014,1,33.7562277,-84.3924169,1,1,0,1,1,0,0,0,0,0,0
4466,137668,2018,Block 2018,49,33.7583423,-84.3900963,49,45,4,45,31,12,0,1,0,1,0
4467,137674,2024,Block 2024,26,33.756353,-84.3851854,26,22,4,22,8,12,1,1,0,0,0
4468,137677,2027,Block 2027,1,33.7550636,-84.3868064,1,1,0,1,0,0,0,0,0,0,1
4469,137685,2035,Block 2035,21,33.7573826,-84.3901665,21,19,2,19,10,9,0,0,0,0,0
4470,137686,2036,Block 2036,11,33.7568709,-84.3896389,11,9,2,9,4,3,0,0,0,2,0
4471,137691,2041,Block 2041,104,33.7559185,-84.3897404,104,92,12,92,68,17,0,2,0,0,5
4472,137693,2043,Block 2043,88,33.756943,-84.3907868,88,42,46,42,4,35,0,2,0,1,0
4473,137694,2044,Block 2044,1,33.7564494,-84.3914727,1,1,0,1,0,0,1,0,0,0,0
4474,137697,2047,Block 2047,115,33.7549072,-84.3898925,115,90,25,90,58,21,0,7,0,1,3
4475,137698,2048,Block 2048,64,33.755447,-84.3892948,64,53,11,53,34,15,0,2,0,0,2
4476,137700,2050,Block 2050,87,33.7545929,-84.3914692,87,61,26,61,24,30,0,2,0,2,3
4477,137702,2052,Block 2052,1,33.7544403,-84.3898083,1,0,1,0,0,0,0,0,0,0,0
4478,137703,2053,Block 2053,20,33.7542818,-84.3891515,20,18,2,18,2,16,0,0,0,0,0
4479,137704,2054,Block 2054,2,33.7538579,-84.3880107,2,1,1,1,1,0,0,0,0,0,0
4480,137706,2056,Block 2056,1,33.7542735,-84.3872206,1,1,0,1,0,0,0,0,1,0,0
4481,137710,2060,Block 2060,18,33.753631,-84.3820898,18,12,6,12,6,6,0,0,0,0,0
4482,137711,2061,Block 2061,45,33.7541773,-84.3811034,45,40,5,40,4,35,0,0,0,0,1
4483,137716,2066,Block 2066,144,33.7518869,-84.3779175,144,143,1,143,13,128,0,0,0,0,2
4484,137720,2070,Block 2070,12,33.7505666,-84.380378,12,1,11,1,0,1,0,0,0,0,0
4485,137738,2088,Block 2088,188,33.7495324,-84.3781416,188,153,35,153,61,81,0,4,0,0,7
4486,137748,1005,Block 1005,219,33.7464649,-84.3962137,219,217,2,217,40,165,0,0,0,2,10
4487,137781,1038,Block 1038,1,33.7360663,-84.3920111,1,1,0,1,0,1,0,0,0,0,0
4488,137788,1045,Block 1045,1,33.7433439,-84.3930757,1,0,1,0,0,0,0,0,0,0,0
4489,137789,1046,Block 1046,5,33.7326351,-84.3928049,5,3,2,3,0,3,0,0,0,0,0
4490,137790,1047,Block 1047,1,33.7344878,-84.3930756,1,0,1,0,0,0,0,0,0,0,0
4491,137791,1048,Block 1048,24,33.7320718,-84.3955699,24,22,2,22,3,19,0,0,0,0,0
4492,137792,1049,Block 1049,15,33.7333849,-84.3976872,15,8,7,8,0,8,0,0,0,0,0
4493,137794,1051,Block 1051,20,33.734933,-84.3977237,20,13,7,13,0,13,0,0,0,0,0
4494,137795,1052,Block 1052,19,33.7362667,-84.3977022,19,11,8,11,0,11,0,0,0,0,0
4495,137796,1053,Block 1053,32,33.7375156,-84.3976776,32,27,5,27,0,27,0,0,0,0,0
4496,137797,1054,Block 1054,38,33.7388231,-84.3976645,38,37,1,37,0,35,0,0,0,1,1
4497,137798,1055,Block 1055,44,33.7401347,-84.3970335,44,39,5,39,1,38,0,0,0,0,0
4498,137799,1056,Block 1056,137,33.7413462,-84.3970191,137,131,6,131,1,129,0,0,0,0,1
4499,137801,1058,Block 1058,30,33.7425781,-84.396342,30,13,17,13,0,12,1,0,0,0,0
4500,137806,1063,Block 1063,100,33.7413276,-84.3939668,100,86,14,86,9,75,0,0,1,1,0
4501,137808,1065,Block 1065,39,33.7374889,-84.39643,39,26,13,26,0,26,0,0,0,0,0
4502,137809,1066,Block 1066,59,33.7388057,-84.3964041,59,50,9,50,2,48,0,0,0,0,0
4503,137810,1067,Block 1067,29,33.7387947,-84.3951802,29,15,14,15,2,12,0,0,0,0,1
4504,137811,1068,Block 1068,9,33.7401302,-84.3951569,9,4,5,4,0,4,0,0,0,0,0
4505,137812,1069,Block 1069,1,33.7413292,-84.3951361,1,1,0,1,1,0,0,0,0,0,0
4506,137813,1070,Block 1070,6,33.7387852,-84.3940179,6,6,0,6,0,5,0,1,0,0,0
4507,137814,1071,Block 1071,8,33.7401254,-84.3939938,8,7,1,7,2,5,0,0,0,0,0
4508,137818,1075,Block 1075,22,33.7294897,-84.3941439,22,12,10,12,0,11,0,0,0,1,0
4509,137819,1076,Block 1076,14,33.729064,-84.3948254,14,4,10,4,1,3,0,0,0,0,0
4510,137820,1077,Block 1077,50,33.7314385,-84.3953751,50,37,13,37,3,34,0,0,0,0,0
4511,137821,1078,Block 1078,15,33.7339459,-84.396495,15,13,2,13,3,9,0,0,0,0,1
4512,137822,1079,Block 1079,23,33.7350981,-84.3964767,23,17,6,17,0,16,0,1,0,0,0
4513,137823,1080,Block 1080,15,33.736252,-84.3964633,15,9,6,9,0,9,0,0,0,0,0
4514,137824,1081,Block 1081,8,33.7362492,-84.3952264,8,2,6,2,0,1,0,0,0,0,1
4515,137830,1087,Block 1087,4,33.7345872,-84.3940187,4,2,2,2,1,1,0,0,0,0,0
4516,137831,1088,Block 1088,35,33.7348623,-84.3952291,35,12,23,12,0,12,0,0,0,0,0
4517,137832,1089,Block 1089,21,33.7336965,-84.3950854,21,20,1,20,3,17,0,0,0,0,0
4518,137833,1090,Block 1090,52,33.7328165,-84.3955171,52,46,6,46,3,41,0,0,0,0,2
4519,137843,2004,Block 2004,48,33.733573,-84.3886677,48,48,0,48,0,48,0,0,0,0,0
4520,137846,2007,Block 2007,59,33.7311027,-84.3901834,59,35,24,35,2,31,0,0,0,0,2
4521,137847,2008,Block 2008,84,33.7310839,-84.388692,84,75,9,75,0,74,0,0,0,0,1
4522,137848,2009,Block 2009,27,33.7285001,-84.388733,27,20,7,20,4,16,0,0,0,0,0
4523,137849,2010,Block 2010,55,33.729418,-84.3902094,55,31,24,31,4,26,0,0,0,0,1
4524,137851,2012,Block 2012,66,33.7292451,-84.3915322,66,44,22,44,1,40,0,0,0,1,2
4525,137853,2014,Block 2014,77,33.7270992,-84.3902487,77,63,14,63,2,61,0,0,0,0,0
4526,137854,2015,Block 2015,60,33.7269036,-84.3915261,60,42,18,42,1,28,1,1,0,10,1
4527,137855,2016,Block 2016,14,33.7253956,-84.3902442,14,13,1,13,0,13,0,0,0,0,0
4528,137857,2018,Block 2018,16,33.7239886,-84.3889369,16,11,5,11,2,7,0,1,0,0,1
4529,137858,2019,Block 2019,1,33.7258056,-84.3887823,1,0,1,0,0,0,0,0,0,0,0
